Player Type,Total Score,World Size,Wumpus Probability,Obstacle Probability,Pit Probability,Total Deaths,Pit Deaths,Wumpus Deaths,Have gold,Have gold int,WumpusKilled,RoomsExplored
ReactivePlayer,-100146,20,0.300000,0.300000,0.300000,99,82,17,false,0,17,234
ReactivePlayer,-100928,20,0.300000,0.300000,0.300000,100,82,18,false,0,18,169
ReactivePlayer,-100120,20,0.300000,0.300000,0.300000,99,80,19,false,0,19,192
ReactivePlayer,-100310,20,0.300000,0.300000,0.300000,98,80,18,false,0,18,283
ReactivePlayer,-100680,20,0.300000,0.300000,0.300000,99,83,16,false,0,16,193
ReactivePlayer,-100256,20,0.300000,0.300000,0.300000,99,79,20,false,0,20,256
ReactivePlayer,-100434,20,0.300000,0.300000,0.300000,99,87,12,false,0,12,196
ReactivePlayer,-100874,20,0.300000,0.300000,0.300000,100,86,14,false,0,14,172
ReactivePlayer,-100848,20,0.300000,0.300000,0.300000,100,88,12,false,0,12,158
ReactivePlayer,-100457,20,0.300000,0.300000,0.300000,100,93,7,false,0,7,96
ReactivePlayer,-10368,20,0.300000,0.300000,0.300000,11,6,5,true,1,5,84
ReactivePlayer,-7097,20,0.300000,0.300000,0.300000,8,6,2,true,1,2,33
ReactivePlayer,-100378,20,0.300000,0.300000,0.300000,99,77,22,false,0,22,287
ReactivePlayer,-21231,20,0.300000,0.300000,0.300000,22,18,4,true,1,4,89
ReactivePlayer,-100588,20,0.300000,0.300000,0.300000,100,88,12,false,0,12,143
ReactivePlayer,-100916,20,0.300000,0.300000,0.300000,100,81,19,false,0,19,191
ReactivePlayer,-21142,20,0.300000,0.300000,0.300000,22,13,9,true,1,9,54
ReactivePlayer,-100535,20,0.300000,0.300000,0.300000,99,77,22,false,0,22,233
ReactivePlayer,-57911,20,0.300000,0.300000,0.300000,58,40,18,true,1,18,233
ReactivePlayer,-100039,20,0.300000,0.300000,0.300000,99,91,8,false,0,8,143
ReactivePlayer,-69840,20,0.300000,0.300000,0.300000,70,45,25,true,1,25,219
ReactivePlayer,-100864,20,0.300000,0.300000,0.300000,100,84,16,false,0,16,159
ReactivePlayer,-1009,20,0.300000,0.300000,0.300000,2,1,1,true,1,1,7
ReactivePlayer,-100933,20,0.300000,0.300000,0.300000,100,87,13,false,0,13,213
ReactivePlayer,-100123,20,0.300000,0.300000,0.300000,99,83,16,false,0,16,185
ReactivePlayer,-100649,20,0.300000,0.300000,0.300000,98,74,24,false,0,24,292
ReactivePlayer,-30557,20,0.300000,0.300000,0.300000,31,18,13,true,1,13,193
ReactivePlayer,-100539,20,0.300000,0.300000,0.300000,99,83,16,false,0,16,291
ReactivePlayer,-100782,20,0.300000,0.300000,0.300000,100,86,14,false,0,14,193
ReactivePlayer,-100785,20,0.300000,0.300000,0.300000,100,97,3,false,0,3,74
ReactivePlayer,-100297,20,0.300000,0.300000,0.300000,99,73,26,false,0,26,262
ReactivePlayer,-45,20,0.300000,0.300000,0.300000,1,0,1,true,1,1,24
ReactivePlayer,-38654,20,0.300000,0.300000,0.300000,39,28,11,true,1,11,142
ReactivePlayer,-30280,20,0.300000,0.300000,0.300000,31,26,5,true,1,5,51
ReactivePlayer,-100136,20,0.300000,0.300000,0.300000,99,82,17,false,0,17,179
ReactivePlayer,-100060,20,0.300000,0.300000,0.300000,99,86,13,false,0,13,224
ReactivePlayer,-100216,20,0.300000,0.300000,0.300000,99,76,23,false,0,23,245
ReactivePlayer,-35925,20,0.300000,0.300000,0.300000,36,28,8,true,1,8,170
ReactivePlayer,-100759,20,0.300000,0.300000,0.300000,100,95,5,false,0,5,117
ReactivePlayer,-100298,20,0.300000,0.300000,0.300000,99,84,15,false,0,15,231
ReactivePlayer,-100865,20,0.300000,0.300000,0.300000,100,90,10,false,0,10,198
ReactivePlayer,-100900,20,0.300000,0.300000,0.300000,100,94,6,false,0,6,66
ReactivePlayer,-14150,20,0.300000,0.300000,0.300000,15,11,4,true,1,4,65
ReactivePlayer,-70374,20,0.300000,0.300000,0.300000,70,47,23,true,1,23,259
ReactivePlayer,-100806,20,0.300000,0.300000,0.300000,100,85,15,false,0,15,184
ReactivePlayer,-5084,20,0.300000,0.300000,0.300000,6,3,3,true,1,3,40
ReactivePlayer,-19378,20,0.300000,0.300000,0.300000,20,10,10,true,1,10,72
ReactivePlayer,-100671,20,0.300000,0.300000,0.300000,100,84,16,false,0,16,151
ReactivePlayer,-4113,20,0.300000,0.300000,0.300000,5,3,2,true,1,2,44
ReactivePlayer,-100971,20,0.300000,0.300000,0.300000,100,84,16,false,0,16,192
ReactivePlayer,-100510,20,0.300000,0.300000,0.300000,99,78,21,false,0,21,229
ReactivePlayer,-66634,20,0.300000,0.300000,0.300000,67,51,16,true,1,16,182
ReactivePlayer,-66035,20,0.300000,0.300000,0.300000,66,47,19,true,1,19,196
ReactivePlayer,-47575,20,0.300000,0.300000,0.300000,48,38,10,true,1,10,160
ReactivePlayer,-100485,20,0.300000,0.300000,0.300000,99,83,16,false,0,16,276
ReactivePlayer,-37305,20,0.300000,0.300000,0.300000,38,31,7,true,1,7,118
ReactivePlayer,-100920,20,0.300000,0.300000,0.300000,100,87,13,false,0,13,170
ReactivePlayer,-27395,20,0.300000,0.300000,0.300000,28,17,11,true,1,11,125
ReactivePlayer,-100998,20,0.300000,0.300000,0.300000,100,87,13,false,0,13,163
ReactivePlayer,-100946,20,0.300000,0.300000,0.300000,100,83,17,false,0,17,236
ReactivePlayer,-100031,20,0.300000,0.300000,0.300000,99,84,15,false,0,15,176
ReactivePlayer,-11144,20,0.300000,0.300000,0.300000,12,8,4,true,1,4,64
ReactivePlayer,-43676,20,0.300000,0.300000,0.300000,44,37,7,true,1,7,113
ReactivePlayer,-84824,20,0.300000,0.300000,0.300000,85,82,3,true,1,3,99
ReactivePlayer,-7141,20,0.300000,0.300000,0.300000,8,6,2,true,1,2,25
ReactivePlayer,-100152,20,0.300000,0.300000,0.300000,99,82,17,false,0,17,175
ReactivePlayer,-100082,20,0.300000,0.300000,0.300000,99,88,11,false,0,11,172
ReactivePlayer,-22515,20,0.300000,0.300000,0.300000,23,14,9,true,1,9,135
ReactivePlayer,-100107,20,0.300000,0.300000,0.300000,99,86,13,false,0,13,164
ReactivePlayer,-100543,20,0.300000,0.300000,0.300000,99,83,16,false,0,16,273
ReactivePlayer,-100732,20,0.300000,0.300000,0.300000,100,96,4,false,0,4,90
ReactivePlayer,-100255,20,0.300000,0.300000,0.300000,99,89,10,false,0,10,143
ReactivePlayer,-74639,20,0.300000,0.300000,0.300000,75,67,8,true,1,8,149
ReactivePlayer,-1014,20,0.300000,0.300000,0.300000,2,0,2,true,1,2,8
ReactivePlayer,-100207,20,0.300000,0.300000,0.300000,99,85,14,false,0,14,145
ReactivePlayer,-46470,20,0.300000,0.300000,0.300000,47,34,13,true,1,13,150
ReactivePlayer,-100989,20,0.300000,0.300000,0.300000,100,85,15,false,0,15,165
ReactivePlayer,-50602,20,0.300000,0.300000,0.300000,51,40,11,true,1,11,148
ReactivePlayer,-100301,20,0.300000,0.300000,0.300000,99,79,20,false,0,20,198
ReactivePlayer,-100298,20,0.300000,0.300000,0.300000,99,81,18,false,0,18,263
ReactivePlayer,-100178,20,0.300000,0.300000,0.300000,99,76,23,false,0,23,178
ReactivePlayer,-31304,20,0.300000,0.300000,0.300000,32,22,10,true,1,10,112
ReactivePlayer,-32613,20,0.300000,0.300000,0.300000,33,24,9,true,1,9,141
ReactivePlayer,-70792,20,0.300000,0.300000,0.300000,71,49,22,true,1,22,222
ReactivePlayer,-26236,20,0.300000,0.300000,0.300000,27,22,5,true,1,5,87
ReactivePlayer,-100111,20,0.300000,0.300000,0.300000,99,90,9,false,0,9,157
ReactivePlayer,-100971,20,0.300000,0.300000,0.300000,100,89,11,false,0,11,125
ReactivePlayer,-100943,20,0.300000,0.300000,0.300000,100,86,14,false,0,14,189
ReactivePlayer,-100475,20,0.300000,0.300000,0.300000,99,80,19,false,0,19,225
ReactivePlayer,-36451,20,0.300000,0.300000,0.300000,37,30,7,true,1,7,112
ReactivePlayer,-100632,20,0.300000,0.300000,0.300000,99,89,10,false,0,10,123
ReactivePlayer,-100128,20,0.300000,0.300000,0.300000,99,78,21,false,0,21,221
ReactivePlayer,-30368,20,0.300000,0.300000,0.300000,31,24,7,true,1,7,94
ReactivePlayer,-36308,20,0.300000,0.300000,0.300000,37,26,11,true,1,11,119
ReactivePlayer,-100830,20,0.300000,0.300000,0.300000,100,88,12,false,0,12,176
ReactivePlayer,-59673,20,0.300000,0.300000,0.300000,60,43,17,true,1,17,173
ReactivePlayer,-100851,20,0.300000,0.300000,0.300000,99,79,20,false,0,20,308
ReactivePlayer,-21244,20,0.300000,0.300000,0.300000,22,15,7,true,1,7,96
ReactivePlayer,-100062,20,0.300000,0.300000,0.300000,99,89,10,false,0,10,130
ReactivePlayer,-100439,20,0.300000,0.300000,0.300000,99,82,17,false,0,17,245
ReactivePlayer,-100429,20,0.300000,0.300000,0.300000,99,83,16,false,0,16,244
ReactivePlayer,-71315,20,0.300000,0.300000,0.300000,71,53,18,true,1,18,299
ReactivePlayer,-6067,20,0.300000,0.300000,0.300000,7,4,3,true,1,3,33
ReactivePlayer,-100027,20,0.300000,0.300000,0.300000,99,89,10,false,0,10,251
ReactivePlayer,-85704,20,0.300000,0.300000,0.300000,86,70,16,true,1,16,167
ReactivePlayer,-101000,20,0.300000,0.300000,0.300000,100,84,16,false,0,16,190
ReactivePlayer,-14137,20,0.300000,0.300000,0.300000,15,12,3,true,1,3,35
ReactivePlayer,-80181,20,0.300000,0.300000,0.300000,80,59,21,true,1,21,259
ReactivePlayer,-72725,20,0.300000,0.300000,0.300000,73,63,10,true,1,10,140
ReactivePlayer,-100942,20,0.300000,0.300000,0.300000,100,86,14,false,0,14,201
ReactivePlayer,-100943,20,0.300000,0.300000,0.300000,100,83,17,false,0,17,196
ReactivePlayer,-100889,20,0.300000,0.300000,0.300000,100,91,9,false,0,9,159
ReactivePlayer,-100127,20,0.300000,0.300000,0.300000,99,89,10,false,0,10,174
ReactivePlayer,-39679,20,0.300000,0.300000,0.300000,40,32,8,true,1,8,116
ReactivePlayer,-3049,20,0.300000,0.300000,0.300000,4,1,3,true,1,3,25
ReactivePlayer,-100190,20,0.300000,0.300000,0.300000,99,86,13,false,0,13,221
ReactivePlayer,-100972,20,0.300000,0.300000,0.300000,100,84,16,false,0,16,163
ReactivePlayer,-100653,20,0.300000,0.300000,0.300000,99,82,17,false,0,17,226
ReactivePlayer,-100746,20,0.300000,0.300000,0.300000,99,68,31,false,0,31,315
ReactivePlayer,-18291,20,0.300000,0.300000,0.300000,19,15,4,true,1,4,83
ReactivePlayer,-84087,20,0.300000,0.300000,0.300000,84,67,17,true,1,17,226
ReactivePlayer,-4053,20,0.300000,0.300000,0.300000,5,4,1,true,1,1,25
ReactivePlayer,-100209,20,0.300000,0.300000,0.300000,99,81,18,false,0,18,204
ReactivePlayer,-100272,20,0.300000,0.300000,0.300000,99,82,17,false,0,17,220
ReactivePlayer,-100758,20,0.300000,0.300000,0.300000,99,76,23,false,0,23,274
ReactivePlayer,-17,20,0.300000,0.300000,0.300000,1,1,0,true,1,0,8
ReactivePlayer,-28337,20,0.300000,0.300000,0.300000,29,26,3,true,1,3,85
ReactivePlayer,-100141,20,0.300000,0.300000,0.300000,99,77,22,false,0,22,227
ReactivePlayer,-100841,20,0.300000,0.300000,0.300000,99,82,17,false,0,17,297
ReactivePlayer,-100235,20,0.300000,0.300000,0.300000,99,95,4,false,0,4,129
ReactivePlayer,-100844,20,0.300000,0.300000,0.300000,100,89,11,false,0,11,191
ReactivePlayer,-5137,20,0.300000,0.300000,0.300000,6,5,1,true,1,1,42
ReactivePlayer,-45408,20,0.300000,0.300000,0.300000,46,36,10,true,1,10,100
ReactivePlayer,-100395,20,0.300000,0.300000,0.300000,99,84,15,false,0,15,256
ReactivePlayer,-100735,20,0.300000,0.300000,0.300000,99,80,19,false,0,19,292
ReactivePlayer,-100610,20,0.300000,0.300000,0.300000,99,86,13,false,0,13,182
ReactivePlayer,-1029,20,0.300000,0.300000,0.300000,2,0,2,true,1,2,19
ReactivePlayer,-20241,20,0.300000,0.300000,0.300000,21,15,6,true,1,6,95
ReactivePlayer,-100821,20,0.300000,0.300000,0.300000,100,81,19,false,0,19,193
ReactivePlayer,-100213,20,0.300000,0.300000,0.300000,99,80,19,false,0,19,259
ReactivePlayer,-100902,20,0.300000,0.300000,0.300000,100,89,11,false,0,11,123
ReactivePlayer,-14262,20,0.300000,0.300000,0.300000,15,6,9,true,1,9,87
ReactivePlayer,-11152,20,0.300000,0.300000,0.300000,12,9,3,true,1,3,48
ReactivePlayer,-65942,20,0.300000,0.300000,0.300000,66,55,11,true,1,11,167
ReactivePlayer,-100942,20,0.300000,0.300000,0.300000,100,91,9,false,0,9,136
ReactivePlayer,-8065,20,0.300000,0.300000,0.300000,9,6,3,true,1,3,40
ReactivePlayer,-10105,20,0.300000,0.300000,0.300000,11,10,1,true,1,1,25
ReactivePlayer,-58334,20,0.300000,0.300000,0.300000,58,44,14,true,1,14,233
ReactivePlayer,-100735,20,0.300000,0.300000,0.300000,100,86,14,false,0,14,172
ReactivePlayer,-100969,20,0.300000,0.300000,0.300000,100,93,7,false,0,7,78
ReactivePlayer,-100280,20,0.300000,0.300000,0.300000,99,81,18,false,0,18,202
ReactivePlayer,-100190,20,0.300000,0.300000,0.300000,99,81,18,false,0,18,204
ReactivePlayer,-98978,20,0.300000,0.300000,0.300000,99,82,17,true,1,17,190
ReactivePlayer,-100740,20,0.300000,0.300000,0.300000,100,91,9,false,0,9,130
ReactivePlayer,-100000,20,0.300000,0.300000,0.300000,99,85,14,false,0,14,202
ReactivePlayer,-100305,20,0.300000,0.300000,0.300000,99,76,23,false,0,23,262
ReactivePlayer,-100881,20,0.300000,0.300000,0.300000,100,84,16,false,0,16,211
ReactivePlayer,-100109,20,0.300000,0.300000,0.300000,99,83,16,false,0,16,223
ReactivePlayer,-100397,20,0.300000,0.300000,0.300000,99,76,23,false,0,23,258
ReactivePlayer,-100854,20,0.300000,0.300000,0.300000,99,76,23,false,0,23,310
ReactivePlayer,994,20,0.300000,0.300000,0.300000,0,0,0,true,1,0,3
ReactivePlayer,-61182,20,0.300000,0.300000,0.300000,61,52,9,true,1,9,177
ReactivePlayer,-100104,20,0.300000,0.300000,0.300000,99,87,12,false,0,12,128
ReactivePlayer,999,20,0.300000,0.300000,0.300000,0,0,0,true,1,0,1
ReactivePlayer,-41461,20,0.300000,0.300000,0.300000,42,32,10,true,1,10,164
ReactivePlayer,-100251,20,0.300000,0.300000,0.300000,99,88,11,false,0,11,173
ReactivePlayer,-64686,20,0.300000,0.300000,0.300000,65,56,9,true,1,9,134
ReactivePlayer,-42309,20,0.300000,0.300000,0.300000,43,39,4,true,1,4,73
ReactivePlayer,-100998,20,0.300000,0.300000,0.300000,100,91,9,false,0,9,199
ReactivePlayer,-28644,20,0.300000,0.300000,0.300000,29,16,13,true,1,13,159
ReactivePlayer,-5228,20,0.300000,0.300000,0.300000,6,1,5,true,1,5,61
ReactivePlayer,-71612,20,0.300000,0.300000,0.300000,72,62,10,true,1,10,131
ReactivePlayer,-100695,20,0.300000,0.300000,0.300000,99,82,17,false,0,17,262
ReactivePlayer,-92385,20,0.300000,0.300000,0.300000,92,80,12,true,1,12,153
ReactivePlayer,-22729,20,0.300000,0.300000,0.300000,23,15,8,true,1,8,114
ReactivePlayer,-100398,20,0.300000,0.300000,0.300000,99,88,11,false,0,11,224
ReactivePlayer,-17154,20,0.300000,0.300000,0.300000,18,10,8,true,1,8,54
ReactivePlayer,-100777,20,0.300000,0.300000,0.300000,99,80,19,false,0,19,230
ReactivePlayer,-100414,20,0.300000,0.300000,0.300000,99,92,7,false,0,7,139
ReactivePlayer,-100289,20,0.300000,0.300000,0.300000,99,87,12,false,0,12,192
ReactivePlayer,-100144,20,0.300000,0.300000,0.300000,99,91,8,false,0,8,168
ReactivePlayer,-3080,20,0.300000,0.300000,0.300000,4,0,4,true,1,4,39
ReactivePlayer,-100777,20,0.300000,0.300000,0.300000,100,85,15,false,0,15,196
ReactivePlayer,-100573,20,0.300000,0.300000,0.300000,99,82,17,false,0,17,284
ReactivePlayer,-17299,20,0.300000,0.300000,0.300000,18,9,9,true,1,9,113
ReactivePlayer,-52779,20,0.300000,0.300000,0.300000,53,44,9,true,1,9,150
ReactivePlayer,-62542,20,0.300000,0.300000,0.300000,63,49,14,true,1,14,153
ReactivePlayer,-26170,20,0.300000,0.300000,0.300000,27,19,8,true,1,8,89
ReactivePlayer,-87606,20,0.300000,0.300000,0.300000,88,81,7,true,1,7,117
ReactivePlayer,-100986,20,0.300000,0.300000,0.300000,100,78,22,false,0,22,238
ReactivePlayer,-1023,20,0.300000,0.300000,0.300000,2,0,2,true,1,2,10
ReactivePlayer,-100339,20,0.300000,0.300000,0.300000,99,91,8,false,0,8,180
ReactivePlayer,-28422,20,0.300000,0.300000,0.300000,29,17,12,true,1,12,110
ReactivePlayer,-100696,20,0.300000,0.300000,0.300000,100,92,8,false,0,8,129
ReactivePlayer,-71550,20,0.300000,0.300000,0.300000,72,60,12,true,1,12,176
ReactivePlayer,-28464,20,0.300000,0.300000,0.300000,29,20,9,true,1,9,115
ReactivePlayer,-74917,20,0.300000,0.300000,0.300000,75,65,10,true,1,10,174
ReactivePlayer,-57064,20,0.300000,0.300000,0.300000,57,39,18,true,1,18,237
ReactivePlayer,-100992,20,0.300000,0.300000,0.300000,100,81,19,false,0,19,253
ReactivePlayer,-100132,20,0.300000,0.300000,0.300000,99,82,17,false,0,17,178
ReactivePlayer,-100101,20,0.300000,0.300000,0.300000,99,74,25,false,0,25,198
ReactivePlayer,-100700,20,0.300000,0.300000,0.300000,99,79,20,false,0,20,245
ReactivePlayer,-100019,20,0.300000,0.300000,0.300000,99,88,11,false,0,11,176
ReactivePlayer,-85321,20,0.300000,0.300000,0.300000,85,69,16,true,1,16,183
ReactivePlayer,-6070,20,0.300000,0.300000,0.300000,7,5,2,true,1,2,30
ReactivePlayer,-69474,20,0.300000,0.300000,0.300000,70,57,13,true,1,13,146
ReactivePlayer,-5116,20,0.300000,0.300000,0.300000,6,2,4,true,1,4,48
ReactivePlayer,-60669,20,0.300000,0.300000,0.300000,61,49,12,true,1,12,153
ReactivePlayer,-38397,20,0.300000,0.300000,0.300000,39,27,12,true,1,12,122
ReactivePlayer,-15361,20,0.300000,0.300000,0.300000,16,11,5,true,1,5,90
ReactivePlayer,-100733,20,0.300000,0.300000,0.300000,100,87,13,false,0,13,195
ReactivePlayer,-12404,20,0.300000,0.300000,0.300000,13,10,3,true,1,3,92
ReactivePlayer,-100289,20,0.300000,0.300000,0.300000,99,87,12,false,0,12,190
ReactivePlayer,-100330,20,0.300000,0.300000,0.300000,99,89,10,false,0,10,186
ReactivePlayer,-100016,20,0.300000,0.300000,0.300000,99,83,16,false,0,16,136
ReactivePlayer,-46803,20,0.300000,0.300000,0.300000,47,33,14,true,1,14,218
ReactivePlayer,-97623,20,0.300000,0.300000,0.300000,98,83,15,true,1,15,175
ReactivePlayer,-3123,20,0.300000,0.300000,0.300000,4,2,2,true,1,2,44
ReactivePlayer,-100172,20,0.300000,0.300000,0.300000,99,79,20,false,0,20,231
ReactivePlayer,-33469,20,0.300000,0.300000,0.300000,34,24,10,true,1,10,130
ReactivePlayer,-62492,20,0.300000,0.300000,0.300000,63,50,13,true,1,13,158
ReactivePlayer,-44722,20,0.300000,0.300000,0.300000,45,35,10,true,1,10,146
ReactivePlayer,-100096,20,0.300000,0.300000,0.300000,99,77,22,false,0,22,199
ReactivePlayer,-9086,20,0.300000,0.300000,0.300000,10,8,2,true,1,2,37
ReactivePlayer,-4061,20,0.300000,0.300000,0.300000,5,1,4,true,1,4,36
ReactivePlayer,-100897,20,0.300000,0.300000,0.300000,100,81,19,false,0,19,232
ReactivePlayer,-100747,20,0.300000,0.300000,0.300000,99,76,23,false,0,23,299
ReactivePlayer,-54361,20,0.300000,0.300000,0.300000,54,33,21,true,1,21,248
ReactivePlayer,-100028,20,0.300000,0.300000,0.300000,99,88,11,false,0,11,163
ReactivePlayer,-100995,20,0.300000,0.300000,0.300000,99,80,19,false,0,19,293
ReactivePlayer,-100319,20,0.300000,0.300000,0.300000,99,83,16,false,0,16,226
ReactivePlayer,-43812,20,0.300000,0.300000,0.300000,44,39,5,true,1,5,180
ReactivePlayer,-11332,20,0.300000,0.300000,0.300000,12,6,6,true,1,6,98
ReactivePlayer,-42281,20,0.300000,0.300000,0.300000,43,27,16,true,1,16,92
ReactivePlayer,-100741,20,0.300000,0.300000,0.300000,100,83,17,false,0,17,179
ReactivePlayer,-87164,20,0.300000,0.300000,0.300000,87,72,15,true,1,15,192
ReactivePlayer,-100000,20,0.300000,0.300000,0.300000,99,82,17,false,0,17,222
ReactivePlayer,-100894,20,0.300000,0.300000,0.300000,100,92,8,false,0,8,106
ReactivePlayer,-100534,20,0.300000,0.300000,0.300000,99,88,11,false,0,11,195
ReactivePlayer,-3097,20,0.300000,0.300000,0.300000,4,1,3,true,1,3,40
ReactivePlayer,-63761,20,0.300000,0.300000,0.300000,63,51,12,true,1,12,234
ReactivePlayer,-100130,20,0.300000,0.300000,0.300000,99,87,12,false,0,12,227
ReactivePlayer,-100381,20,0.300000,0.300000,0.300000,99,83,16,false,0,16,262
ReactivePlayer,-100043,20,0.300000,0.300000,0.300000,99,83,16,false,0,16,220
ReactivePlayer,-100575,20,0.300000,0.300000,0.300000,100,99,1,false,0,1,12
ReactivePlayer,-100393,20,0.300000,0.300000,0.300000,99,83,16,false,0,16,207
ReactivePlayer,-100388,20,0.300000,0.300000,0.300000,98,78,20,false,0,20,279
ReactivePlayer,-2049,20,0.300000,0.300000,0.300000,3,0,3,true,1,3,28
ReactivePlayer,-100977,20,0.300000,0.300000,0.300000,100,87,13,false,0,13,160
ReactivePlayer,-30330,20,0.300000,0.300000,0.300000,31,18,13,true,1,13,108
ReactivePlayer,-100200,20,0.300000,0.300000,0.300000,99,83,16,false,0,16,169
ReactivePlayer,-100021,20,0.300000,0.300000,0.300000,99,82,17,false,0,17,228
ReactivePlayer,-87013,20,0.300000,0.300000,0.300000,87,68,19,true,1,19,257
ReactivePlayer,-100189,20,0.300000,0.300000,0.300000,99,92,7,false,0,7,139
ReactivePlayer,-100962,20,0.300000,0.300000,0.300000,99,77,22,false,0,22,295
ReactivePlayer,-100799,20,0.300000,0.300000,0.300000,100,94,6,false,0,6,86
ReactivePlayer,-100839,20,0.300000,0.300000,0.300000,99,86,13,false,0,13,252
ReactivePlayer,-100107,20,0.300000,0.300000,0.300000,99,87,12,false,0,12,259
ReactivePlayer,-4087,20,0.300000,0.300000,0.300000,5,1,4,true,1,4,46
ReactivePlayer,-100104,20,0.300000,0.300000,0.300000,99,94,5,false,0,5,177
ReactivePlayer,-22366,20,0.300000,0.300000,0.300000,23,22,1,true,1,1,40
ReactivePlayer,-86446,20,0.300000,0.300000,0.300000,86,66,20,true,1,20,206
ReactivePlayer,-100951,20,0.300000,0.300000,0.300000,99,88,11,false,0,11,256
ReactivePlayer,-100140,20,0.300000,0.300000,0.300000,99,80,19,false,0,19,274
ReactivePlayer,-100325,20,0.300000,0.300000,0.300000,99,83,16,false,0,16,271
ReactivePlayer,-52762,20,0.300000,0.300000,0.300000,53,43,10,true,1,10,143
ReactivePlayer,-15,20,0.300000,0.300000,0.300000,1,1,0,true,1,0,8
ReactivePlayer,-100661,20,0.300000,0.300000,0.300000,100,93,7,false,0,7,149
ReactivePlayer,-20227,20,0.300000,0.300000,0.300000,21,14,7,true,1,7,81
ReactivePlayer,-28206,20,0.300000,0.300000,0.300000,29,23,6,true,1,6,86
ReactivePlayer,-100110,20,0.300000,0.300000,0.300000,99,83,16,false,0,16,215
ReactivePlayer,-41875,20,0.300000,0.300000,0.300000,42,34,8,true,1,8,110
ReactivePlayer,-13486,20,0.300000,0.300000,0.300000,14,9,5,true,1,5,121
ReactivePlayer,-100559,20,0.300000,0.300000,0.300000,99,77,22,false,0,22,206
ReactivePlayer,-38536,20,0.300000,0.300000,0.300000,39,30,9,true,1,9,86
ReactivePlayer,-5058,20,0.300000,0.300000,0.300000,6,4,2,true,1,2,45
ReactivePlayer,-5079,20,0.300000,0.300000,0.300000,6,6,0,true,1,0,29
ReactivePlayer,-100188,20,0.300000,0.300000,0.300000,99,91,8,false,0,8,143
ReactivePlayer,-18486,20,0.300000,0.300000,0.300000,19,11,8,true,1,8,155
ReactivePlayer,980,20,0.300000,0.300000,0.300000,0,0,0,true,1,0,8
ReactivePlayer,-85471,20,0.300000,0.300000,0.300000,85,75,10,true,1,10,236
ReactivePlayer,-46718,20,0.300000,0.300000,0.300000,47,35,12,true,1,12,133
ReactivePlayer,-11209,20,0.300000,0.300000,0.300000,12,8,4,true,1,4,67
ReactivePlayer,-100606,20,0.300000,0.300000,0.300000,99,81,18,false,0,18,266
ReactivePlayer,-100604,20,0.300000,0.300000,0.300000,99,78,21,false,0,21,240
ReactivePlayer,-100005,20,0.300000,0.300000,0.300000,99,84,15,false,0,15,190
ReactivePlayer,-56628,20,0.300000,0.300000,0.300000,57,44,13,true,1,13,204
ReactivePlayer,-58950,20,0.300000,0.300000,0.300000,59,43,16,true,1,16,251
ReactivePlayer,-17212,20,0.300000,0.300000,0.300000,18,13,5,true,1,5,82
ReactivePlayer,-65838,20,0.300000,0.300000,0.300000,66,44,22,true,1,22,235
ReactivePlayer,-100677,20,0.300000,0.300000,0.300000,100,92,8,false,0,8,163
ReactivePlayer,-2049,20,0.300000,0.300000,0.300000,3,2,1,true,1,1,25
ReactivePlayer,-100784,20,0.300000,0.300000,0.300000,99,81,18,false,0,18,230
ReactivePlayer,-14132,20,0.300000,0.300000,0.300000,15,10,5,true,1,5,60
ReactivePlayer,-100797,20,0.300000,0.300000,0.300000,100,87,13,false,0,13,132
ReactivePlayer,-100386,20,0.300000,0.300000,0.300000,99,82,17,false,0,17,292
ReactivePlayer,-100247,20,0.300000,0.300000,0.300000,99,84,15,false,0,15,198
ReactivePlayer,-51383,20,0.300000,0.300000,0.300000,52,44,8,true,1,8,117
ReactivePlayer,-100518,20,0.300000,0.300000,0.300000,99,81,18,false,0,18,201
ReactivePlayer,-100293,20,0.300000,0.300000,0.300000,99,85,14,false,0,14,220
ReactivePlayer,-100041,20,0.300000,0.300000,0.300000,99,84,15,false,0,15,196
ReactivePlayer,-86019,20,0.300000,0.300000,0.300000,86,78,8,true,1,8,79
ReactivePlayer,-100059,20,0.300000,0.300000,0.300000,99,89,10,false,0,10,213
ReactivePlayer,-100000,20,0.300000,0.300000,0.300000,99,82,17,false,0,17,204
ReactivePlayer,-100155,20,0.300000,0.300000,0.300000,99,82,17,false,0,17,203
ReactivePlayer,-100957,20,0.300000,0.300000,0.300000,100,85,15,false,0,15,160
ReactivePlayer,-13211,20,0.300000,0.300000,0.300000,14,11,3,true,1,3,56
ReactivePlayer,-36452,20,0.300000,0.300000,0.300000,37,28,9,true,1,9,147
ReactivePlayer,-100952,20,0.300000,0.300000,0.300000,100,84,16,false,0,16,271
ReactivePlayer,-97024,20,0.300000,0.300000,0.300000,97,71,26,true,1,26,192
ReactivePlayer,-20287,20,0.300000,0.300000,0.300000,21,12,9,true,1,9,99
ReactivePlayer,-86057,20,0.300000,0.300000,0.300000,86,72,14,true,1,14,237
ReactivePlayer,-100244,20,0.300000,0.300000,0.300000,99,83,16,false,0,16,206
ReactivePlayer,-75499,20,0.300000,0.300000,0.300000,75,60,15,true,1,15,205
ReactivePlayer,-100475,20,0.300000,0.300000,0.300000,100,89,11,false,0,11,136
ReactivePlayer,-100049,20,0.300000,0.300000,0.300000,99,83,16,false,0,16,249
ReactivePlayer,-100641,20,0.300000,0.300000,0.300000,99,84,15,false,0,15,265
ReactivePlayer,-11232,20,0.300000,0.300000,0.300000,12,10,2,true,1,2,101
ReactivePlayer,-100016,20,0.300000,0.300000,0.300000,99,84,15,false,0,15,209
ReactivePlayer,-89526,20,0.300000,0.300000,0.300000,90,69,21,true,1,21,165
ReactivePlayer,-100253,20,0.300000,0.300000,0.300000,99,80,19,false,0,19,225
ReactivePlayer,-100141,20,0.300000,0.300000,0.300000,99,82,17,false,0,17,180
ReactivePlayer,-29303,20,0.300000,0.300000,0.300000,30,19,11,true,1,11,99
ReactivePlayer,-46518,20,0.300000,0.300000,0.300000,47,38,9,true,1,9,157
ReactivePlayer,-100791,20,0.300000,0.300000,0.300000,99,79,20,false,0,20,304
ReactivePlayer,-91339,20,0.300000,0.300000,0.300000,91,67,24,true,1,24,286
ReactivePlayer,-100609,20,0.300000,0.300000,0.300000,99,80,19,false,0,19,276
ReactivePlayer,-100839,20,0.300000,0.300000,0.300000,100,90,10,false,0,10,134
ReactivePlayer,-100486,20,0.300000,0.300000,0.300000,99,84,15,false,0,15,246
ReactivePlayer,-94322,20,0.300000,0.300000,0.300000,94,84,10,true,1,10,235
ReactivePlayer,-100556,20,0.300000,0.300000,0.300000,99,89,10,false,0,10,209
ReactivePlayer,-70664,20,0.300000,0.300000,0.300000,71,63,8,true,1,8,111
ReactivePlayer,-100138,20,0.300000,0.300000,0.300000,99,81,18,false,0,18,227
ReactivePlayer,-100294,20,0.300000,0.300000,0.300000,99,84,15,false,0,15,272
ReactivePlayer,-100071,20,0.300000,0.300000,0.300000,99,81,18,false,0,18,167
ReactivePlayer,-11393,20,0.300000,0.300000,0.300000,12,5,7,true,1,7,91
ReactivePlayer,-100044,20,0.300000,0.300000,0.300000,99,93,6,false,0,6,130
ReactivePlayer,-100992,20,0.300000,0.300000,0.300000,100,87,13,false,0,13,241
ReactivePlayer,-6056,20,0.300000,0.300000,0.300000,7,6,1,true,1,1,25
ReactivePlayer,-100000,20,0.300000,0.300000,0.300000,99,84,15,false,0,15,174
ReactivePlayer,-9104,20,0.300000,0.300000,0.300000,10,9,1,true,1,1,34
ReactivePlayer,-100973,20,0.300000,0.300000,0.300000,100,80,20,false,0,20,210
ReactivePlayer,-39599,20,0.300000,0.300000,0.300000,40,24,16,true,1,16,199
ReactivePlayer,-100896,20,0.300000,0.300000,0.300000,100,78,22,false,0,22,181
ReactivePlayer,-100403,20,0.300000,0.300000,0.300000,99,87,12,false,0,12,220
ReactivePlayer,-33727,20,0.300000,0.300000,0.300000,34,20,14,true,1,14,173
ReactivePlayer,-100109,20,0.300000,0.300000,0.300000,98,85,13,false,0,13,223
ReactivePlayer,1000,20,0.300000,0.300000,0.300000,0,0,0,true,1,0,0
ReactivePlayer,-100533,20,0.300000,0.300000,0.300000,99,87,12,false,0,12,233
ReactivePlayer,-20241,20,0.300000,0.300000,0.300000,21,15,6,true,1,6,101
ReactivePlayer,-14276,20,0.300000,0.300000,0.300000,15,9,6,true,1,6,93
ReactivePlayer,-71886,20,0.300000,0.300000,0.300000,72,68,4,true,1,4,111
ReactivePlayer,-100071,20,0.300000,0.300000,0.300000,99,88,11,false,0,11,176
ReactivePlayer,-100587,20,0.300000,0.300000,0.300000,99,79,20,false,0,20,303
ReactivePlayer,-100989,20,0.300000,0.300000,0.300000,100,85,15,false,0,15,193
ReactivePlayer,-100497,20,0.300000,0.300000,0.300000,99,80,19,false,0,19,283
ReactivePlayer,-100846,20,0.300000,0.300000,0.300000,99,73,26,false,0,26,301
ReactivePlayer,-100951,20,0.300000,0.300000,0.300000,100,86,14,false,0,14,127
ReactivePlayer,-100133,20,0.300000,0.300000,0.300000,99,77,22,false,0,22,249
ReactivePlayer,-68792,20,0.300000,0.300000,0.300000,69,51,18,true,1,18,203
ReactivePlayer,-100150,20,0.300000,0.300000,0.300000,99,82,17,false,0,17,301
ReactivePlayer,-90674,20,0.300000,0.300000,0.300000,90,71,19,true,1,19,227
ReactivePlayer,-100086,20,0.300000,0.300000,0.300000,99,78,21,false,0,21,261
ReactivePlayer,-76360,20,0.300000,0.300000,0.300000,76,70,6,true,1,6,158
ReactivePlayer,-100201,20,0.300000,0.300000,0.300000,99,78,21,false,0,21,174
ReactivePlayer,-90413,20,0.300000,0.300000,0.300000,90,75,15,true,1,15,259
ReactivePlayer,-69261,20,0.300000,0.300000,0.300000,69,51,18,true,1,18,192
ReactivePlayer,-100831,20,0.300000,0.300000,0.300000,100,90,10,false,0,10,114
ReactivePlayer,-100849,20,0.300000,0.300000,0.300000,99,72,27,false,0,27,338
ReactivePlayer,-14219,20,0.300000,0.300000,0.300000,15,9,6,true,1,6,67
ReactivePlayer,-100101,20,0.300000,0.300000,0.300000,99,89,10,false,0,10,159
ReactivePlayer,-84234,20,0.300000,0.300000,0.300000,84,62,22,true,1,22,252
ReactivePlayer,-100986,20,0.300000,0.300000,0.300000,100,86,14,false,0,14,187
ReactivePlayer,-100836,20,0.300000,0.300000,0.300000,99,78,21,false,0,21,304
ReactivePlayer,-11175,20,0.300000,0.300000,0.300000,12,9,3,true,1,3,62
ReactivePlayer,-100929,20,0.300000,0.300000,0.300000,100,86,14,false,0,14,135
ReactivePlayer,-100844,20,0.300000,0.300000,0.300000,100,84,16,false,0,16,173
ReactivePlayer,-86551,20,0.300000,0.300000,0.300000,86,67,19,true,1,19,230
ReactivePlayer,-92881,20,0.300000,0.300000,0.300000,92,73,19,true,1,19,280
ReactivePlayer,-100135,20,0.300000,0.300000,0.300000,99,76,23,false,0,23,225
ReactivePlayer,-100716,20,0.300000,0.300000,0.300000,99,84,15,false,0,15,186
ReactivePlayer,-100845,20,0.300000,0.300000,0.300000,99,72,27,false,0,27,293
ReactivePlayer,-10169,20,0.300000,0.300000,0.300000,11,9,2,true,1,2,41
ReactivePlayer,-100155,20,0.300000,0.300000,0.300000,99,88,11,false,0,11,219
ReactivePlayer,-100347,20,0.300000,0.300000,0.300000,99,76,23,false,0,23,229
ReactivePlayer,-29288,20,0.300000,0.300000,0.300000,30,25,5,true,1,5,85
ReactivePlayer,-100061,20,0.300000,0.300000,0.300000,99,84,15,false,0,15,151
ReactivePlayer,-24434,20,0.300000,0.300000,0.300000,25,22,3,true,1,3,70
ReactivePlayer,-100388,20,0.300000,0.300000,0.300000,99,87,12,false,0,12,189
ReactivePlayer,-84331,20,0.300000,0.300000,0.300000,84,63,21,true,1,21,219
ReactivePlayer,-100291,20,0.300000,0.300000,0.300000,99,83,16,false,0,16,228
ReactivePlayer,-29243,20,0.300000,0.300000,0.300000,30,17,13,true,1,13,103
ReactivePlayer,-4080,20,0.300000,0.300000,0.300000,5,3,2,true,1,2,39
ReactivePlayer,-54617,20,0.300000,0.300000,0.300000,55,45,10,true,1,10,137
ReactivePlayer,-100331,20,0.300000,0.300000,0.300000,99,82,17,false,0,17,256
ReactivePlayer,-100396,20,0.300000,0.300000,0.300000,99,84,15,false,0,15,198
ReactivePlayer,-11143,20,0.300000,0.300000,0.300000,12,9,3,true,1,3,54
ReactivePlayer,-100939,20,0.300000,0.300000,0.300000,100,87,13,false,0,13,211
ReactivePlayer,-100329,20,0.300000,0.300000,0.300000,99,81,18,false,0,18,252
ReactivePlayer,-6123,20,0.300000,0.300000,0.300000,7,7,0,true,1,0,27
ReactivePlayer,-3039,20,0.300000,0.300000,0.300000,4,3,1,true,1,1,16
ReactivePlayer,-100201,20,0.300000,0.300000,0.300000,99,91,8,false,0,8,133
ReactivePlayer,-100602,20,0.300000,0.300000,0.300000,100,85,15,false,0,15,141
ReactivePlayer,-68789,20,0.300000,0.300000,0.300000,69,59,10,true,1,10,205
ReactivePlayer,-100041,20,0.300000,0.300000,0.300000,99,80,19,false,0,19,174
ReactivePlayer,-100722,20,0.300000,0.300000,0.300000,99,76,23,false,0,23,229
ReactivePlayer,-100921,20,0.300000,0.300000,0.300000,100,78,22,false,0,22,164
ReactivePlayer,-100021,20,0.300000,0.300000,0.300000,99,85,14,false,0,14,214
ReactivePlayer,-100908,20,0.300000,0.300000,0.300000,99,64,35,false,0,35,327
ReactivePlayer,-100794,20,0.300000,0.300000,0.300000,99,76,23,false,0,23,314
ReactivePlayer,-87362,20,0.300000,0.300000,0.300000,87,59,28,true,1,28,278
ReactivePlayer,-7106,20,0.300000,0.300000,0.300000,8,7,1,true,1,1,52
ReactivePlayer,-49744,20,0.300000,0.300000,0.300000,50,35,15,true,1,15,191
ReactivePlayer,-6044,20,0.300000,0.300000,0.300000,7,6,1,true,1,1,19
ReactivePlayer,-100562,20,0.300000,0.300000,0.300000,99,79,20,false,0,20,282
ReactivePlayer,-100121,20,0.300000,0.300000,0.300000,98,77,21,false,0,21,260
ReactivePlayer,-100038,20,0.300000,0.300000,0.300000,99,91,8,false,0,8,140
ReactivePlayer,-94755,20,0.300000,0.300000,0.300000,94,88,6,true,1,6,178
ReactivePlayer,-18225,20,0.300000,0.300000,0.300000,19,13,6,true,1,6,79
ReactivePlayer,-100000,20,0.300000,0.300000,0.300000,99,79,20,false,0,20,222
ReactivePlayer,-16484,20,0.300000,0.300000,0.300000,17,9,8,true,1,8,109
ReactivePlayer,-100905,20,0.300000,0.300000,0.300000,100,89,11,false,0,11,159
ReactivePlayer,-100907,20,0.300000,0.300000,0.300000,100,85,15,false,0,15,159
ReactivePlayer,-100384,20,0.300000,0.300000,0.300000,99,80,19,false,0,19,236
ReactivePlayer,-100687,20,0.300000,0.300000,0.300000,99,86,13,false,0,13,184
ReactivePlayer,-100978,20,0.300000,0.300000,0.300000,100,88,12,false,0,12,182
ReactivePlayer,-5074,20,0.300000,0.300000,0.300000,6,4,2,true,1,2,27
ReactivePlayer,-73118,20,0.300000,0.300000,0.300000,73,55,18,true,1,18,277
ReactivePlayer,-29187,20,0.300000,0.300000,0.300000,30,21,9,true,1,9,84
ReactivePlayer,-19436,20,0.300000,0.300000,0.300000,20,12,8,true,1,8,87
ReactivePlayer,-100200,20,0.300000,0.300000,0.300000,99,88,11,false,0,11,161
ReactivePlayer,-59687,20,0.300000,0.300000,0.300000,60,49,11,true,1,11,167
ReactivePlayer,-100307,20,0.300000,0.300000,0.300000,99,82,17,false,0,17,240
ReactivePlayer,-12100,20,0.300000,0.300000,0.300000,13,8,5,true,1,5,54
ReactivePlayer,-47710,20,0.300000,0.300000,0.300000,48,46,2,true,1,2,60
ReactivePlayer,-100865,20,0.300000,0.300000,0.300000,100,89,11,false,0,11,177
ReactivePlayer,-52478,20,0.300000,0.300000,0.300000,53,43,10,true,1,10,126
ReactivePlayer,-100766,20,0.300000,0.300000,0.300000,100,90,10,false,0,10,109
ReactivePlayer,-86236,20,0.300000,0.300000,0.300000,86,74,12,true,1,12,243
ReactivePlayer,-100280,20,0.300000,0.300000,0.300000,99,85,14,false,0,14,234
ReactivePlayer,-100131,20,0.300000,0.300000,0.300000,99,77,22,false,0,22,243
ReactivePlayer,-100225,20,0.300000,0.300000,0.300000,99,92,7,false,0,7,214
ReactivePlayer,-100884,20,0.300000,0.300000,0.300000,100,90,10,false,0,10,141
ReactivePlayer,-100153,20,0.300000,0.300000,0.300000,99,78,21,false,0,21,209
ReactivePlayer,-96213,20,0.300000,0.300000,0.300000,96,82,14,true,1,14,145
ReactivePlayer,-23329,20,0.300000,0.300000,0.300000,24,19,5,true,1,5,80
ReactivePlayer,-100260,20,0.300000,0.300000,0.300000,99,86,13,false,0,13,203
ReactivePlayer,-20296,20,0.300000,0.300000,0.300000,21,16,5,true,1,5,68
ReactivePlayer,-100090,20,0.300000,0.300000,0.300000,99,85,14,false,0,14,207
ReactivePlayer,-5128,20,0.300000,0.300000,0.300000,6,4,2,true,1,2,54
ReactivePlayer,-58759,20,0.300000,0.300000,0.300000,59,44,15,true,1,15,198
ReactivePlayer,-100074,20,0.300000,0.300000,0.300000,99,78,21,false,0,21,242
ReactivePlayer,-26184,20,0.300000,0.300000,0.300000,27,20,7,true,1,7,70
ReactivePlayer,-4064,20,0.300000,0.300000,0.300000,5,3,2,true,1,2,25
ReactivePlayer,-72510,20,0.300000,0.300000,0.300000,73,63,10,true,1,10,123
ReactivePlayer,-100991,20,0.300000,0.300000,0.300000,99,73,26,false,0,26,331
ReactivePlayer,-100998,20,0.300000,0.300000,0.300000,99,80,19,false,0,19,260
ReactivePlayer,-45417,20,0.300000,0.300000,0.300000,46,37,9,true,1,9,122
ReactivePlayer,-100727,20,0.300000,0.300000,0.300000,99,85,14,false,0,14,200
ReactivePlayer,-61561,20,0.300000,0.300000,0.300000,62,55,7,true,1,7,61
ReactivePlayer,-100279,20,0.300000,0.300000,0.300000,99,82,17,false,0,17,198
ReactivePlayer,-82054,20,0.300000,0.300000,0.300000,82,62,20,true,1,20,245
ReactivePlayer,-40676,20,0.300000,0.300000,0.300000,41,30,11,true,1,11,149
ReactivePlayer,-100000,20,0.300000,0.300000,0.300000,99,84,15,false,0,15,180
ReactivePlayer,-88870,20,0.300000,0.300000,0.300000,89,66,23,true,1,23,214
ReactivePlayer,-93575,20,0.300000,0.300000,0.300000,93,75,18,true,1,18,255
ReactivePlayer,-64589,20,0.300000,0.300000,0.300000,65,54,11,true,1,11,183
ReactivePlayer,-100242,20,0.300000,0.300000,0.300000,99,82,17,false,0,17,193
ReactivePlayer,-25544,20,0.300000,0.300000,0.300000,26,22,4,true,1,4,96
ReactivePlayer,-69773,20,0.300000,0.300000,0.300000,68,47,21,true,1,21,213
ReactivePlayer,-84880,20,0.300000,0.300000,0.300000,85,69,16,true,1,16,165
ReactivePlayer,-100381,20,0.300000,0.300000,0.300000,99,82,17,false,0,17,243
ReactivePlayer,-69480,20,0.300000,0.300000,0.300000,70,59,11,true,1,11,123
ReactivePlayer,-18221,20,0.300000,0.300000,0.300000,19,17,2,true,1,2,28
ReactivePlayer,-19356,20,0.300000,0.300000,0.300000,20,14,6,true,1,6,68
ReactivePlayer,-43491,20,0.300000,0.300000,0.300000,44,30,14,true,1,14,116
ReactivePlayer,-100259,20,0.300000,0.300000,0.300000,99,79,20,false,0,20,267
ReactivePlayer,-100194,20,0.300000,0.300000,0.300000,99,86,13,false,0,13,175
ReactivePlayer,-6047,20,0.300000,0.300000,0.300000,7,4,3,true,1,3,26
ReactivePlayer,-100590,20,0.300000,0.300000,0.300000,99,83,16,false,0,16,303
ReactivePlayer,-48915,20,0.300000,0.300000,0.300000,49,40,9,true,1,9,195
ReactivePlayer,-100994,20,0.300000,0.300000,0.300000,100,81,19,false,0,19,239
ReactivePlayer,-25643,20,0.300000,0.300000,0.300000,26,20,6,true,1,6,101
ReactivePlayer,-62715,20,0.300000,0.300000,0.300000,63,59,4,true,1,4,94
ReactivePlayer,-100731,20,0.300000,0.300000,0.300000,100,92,8,false,0,8,168
ReactivePlayer,-100119,20,0.300000,0.300000,0.300000,99,83,16,false,0,16,187
ReactivePlayer,-100857,20,0.300000,0.300000,0.300000,100,82,18,false,0,18,213
ReactivePlayer,-100994,20,0.300000,0.300000,0.300000,100,92,8,false,0,8,108
ReactivePlayer,-86892,20,0.300000,0.300000,0.300000,87,73,14,true,1,14,186
ReactivePlayer,-100827,20,0.300000,0.300000,0.300000,100,78,22,false,0,22,198
ReactivePlayer,-100133,20,0.300000,0.300000,0.300000,99,82,17,false,0,17,228
ReactivePlayer,-100737,20,0.300000,0.300000,0.300000,99,77,22,false,0,22,280
ReactivePlayer,-100172,20,0.300000,0.300000,0.300000,99,92,7,false,0,7,112
ReactivePlayer,-100632,20,0.300000,0.300000,0.300000,100,85,15,false,0,15,166
ReactivePlayer,-57982,20,0.300000,0.300000,0.300000,58,47,11,true,1,11,190
ReactivePlayer,-100887,20,0.300000,0.300000,0.300000,100,88,12,false,0,12,172
ReactivePlayer,-100208,20,0.300000,0.300000,0.300000,99,78,21,false,0,21,233
ReactivePlayer,-100411,20,0.300000,0.300000,0.300000,99,82,17,false,0,17,238
ReactivePlayer,-100292,20,0.300000,0.300000,0.300000,99,89,10,false,0,10,162
ReactivePlayer,-8101,20,0.300000,0.300000,0.300000,9,7,2,true,1,2,42
ReactivePlayer,-100903,20,0.300000,0.300000,0.300000,100,83,17,false,0,17,162
ReactivePlayer,-100710,20,0.300000,0.300000,0.300000,100,94,6,false,0,6,50
ReactivePlayer,-100217,20,0.300000,0.300000,0.300000,99,79,20,false,0,20,226
ReactivePlayer,-100439,20,0.300000,0.300000,0.300000,98,75,23,false,0,23,264
ReactivePlayer,-3092,20,0.300000,0.300000,0.300000,4,1,3,true,1,3,29
ReactivePlayer,-12151,20,0.300000,0.300000,0.300000,13,10,3,true,1,3,49
ReactivePlayer,-18545,20,0.300000,0.300000,0.300000,19,9,10,true,1,10,87
ReactivePlayer,-55795,20,0.300000,0.300000,0.300000,56,49,7,true,1,7,131
ReactivePlayer,-15253,20,0.300000,0.300000,0.300000,16,9,7,true,1,7,108
ReactivePlayer,-21255,20,0.300000,0.300000,0.300000,22,12,10,true,1,10,104
ReactivePlayer,-87103,20,0.300000,0.300000,0.300000,87,71,16,true,1,16,259
ReactivePlayer,-84823,20,0.300000,0.300000,0.300000,85,79,6,true,1,6,125
ReactivePlayer,-80008,20,0.300000,0.300000,0.300000,80,66,14,true,1,14,221
ReactivePlayer,-62660,20,0.300000,0.300000,0.300000,63,51,12,true,1,12,158
ReactivePlayer,-100025,20,0.300000,0.300000,0.300000,99,78,21,false,0,21,258
ReactivePlayer,-67916,20,0.300000,0.300000,0.300000,67,48,19,true,1,19,213
ReactivePlayer,-23489,20,0.300000,0.300000,0.300000,24,8,16,true,1,16,131
ReactivePlayer,-26305,20,0.300000,0.300000,0.300000,27,20,7,true,1,7,86
ReactivePlayer,-100335,20,0.300000,0.300000,0.300000,99,91,8,false,0,8,95
ReactivePlayer,-54550,20,0.300000,0.300000,0.300000,55,50,5,true,1,5,105
ReactivePlayer,-13177,20,0.300000,0.300000,0.300000,14,10,4,true,1,4,66
ReactivePlayer,-100930,20,0.300000,0.300000,0.300000,100,88,12,false,0,12,132
ReactivePlayer,-71600,20,0.300000,0.300000,0.300000,72,66,6,true,1,6,120
ReactivePlayer,-21219,20,0.300000,0.300000,0.300000,22,19,3,true,1,3,76
ReactivePlayer,-100076,20,0.300000,0.300000,0.300000,99,82,17,false,0,17,196
ReactivePlayer,-43362,20,0.300000,0.300000,0.300000,44,40,4,true,1,4,68
ReactivePlayer,-55898,20,0.300000,0.300000,0.300000,56,44,12,true,1,12,161
ReactivePlayer,-100456,20,0.300000,0.300000,0.300000,98,87,11,false,0,11,229
ReactivePlayer,-100317,20,0.300000,0.300000,0.300000,99,74,25,false,0,25,297
ReactivePlayer,-9105,20,0.300000,0.300000,0.300000,10,7,3,true,1,3,58
ReactivePlayer,-8083,20,0.300000,0.300000,0.300000,9,2,7,true,1,7,41
ReactivePlayer,-100604,20,0.300000,0.300000,0.300000,99,85,14,false,0,14,224
ReactivePlayer,-100014,20,0.300000,0.300000,0.300000,99,79,20,false,0,20,243
ReactivePlayer,-100224,20,0.300000,0.300000,0.300000,99,84,15,false,0,15,207
ReactivePlayer,-100249,20,0.300000,0.300000,0.300000,99,82,17,false,0,17,182
ReactivePlayer,-100151,20,0.300000,0.300000,0.300000,99,75,24,false,0,24,261
ReactivePlayer,-9084,20,0.300000,0.300000,0.300000,10,5,5,true,1,5,56
ReactivePlayer,-63068,20,0.300000,0.300000,0.300000,62,48,14,true,1,14,202
ReactivePlayer,-100321,20,0.300000,0.300000,0.300000,99,84,15,false,0,15,207
ReactivePlayer,-100296,20,0.300000,0.300000,0.300000,99,85,14,false,0,14,217
ReactivePlayer,-47,20,0.300000,0.300000,0.300000,1,0,1,true,1,1,10
ReactivePlayer,-100875,20,0.300000,0.300000,0.300000,100,84,16,false,0,16,182
ReactivePlayer,-100777,20,0.300000,0.300000,0.300000,100,83,17,false,0,17,197
ReactivePlayer,-100921,20,0.300000,0.300000,0.300000,100,85,15,false,0,15,171
ReactivePlayer,-100341,20,0.300000,0.300000,0.300000,99,90,9,false,0,9,173
ReactivePlayer,-2043,20,0.300000,0.300000,0.300000,3,3,0,true,1,0,22
ReactivePlayer,-100731,20,0.300000,0.300000,0.300000,100,87,13,false,0,13,134
ReactivePlayer,-100218,20,0.300000,0.300000,0.300000,99,80,19,false,0,19,260
ReactivePlayer,-100828,20,0.300000,0.300000,0.300000,100,87,13,false,0,13,173
ReactivePlayer,-34524,20,0.300000,0.300000,0.300000,35,25,10,true,1,10,163
ReactivePlayer,1000,20,0.300000,0.300000,0.300000,0,0,0,true,1,0,0
ReactivePlayer,-100515,20,0.300000,0.300000,0.300000,99,84,15,false,0,15,175
ReactivePlayer,-100889,20,0.300000,0.300000,0.300000,100,91,9,false,0,9,199
ReactivePlayer,-100053,20,0.300000,0.300000,0.300000,99,79,20,false,0,20,184
ReactivePlayer,-100706,20,0.300000,0.300000,0.300000,99,89,10,false,0,10,164
ReactivePlayer,-24320,20,0.300000,0.300000,0.300000,25,22,3,true,1,3,30
ReactivePlayer,-100636,20,0.300000,0.300000,0.300000,99,77,22,false,0,22,230
ReactivePlayer,-100135,20,0.300000,0.300000,0.300000,99,76,23,false,0,23,285
ReactivePlayer,-100038,20,0.300000,0.300000,0.300000,99,74,25,false,0,25,258
ReactivePlayer,-41496,20,0.300000,0.300000,0.300000,42,34,8,true,1,8,135
ReactivePlayer,-100956,20,0.300000,0.300000,0.300000,100,90,10,false,0,10,102
ReactivePlayer,-69318,20,0.300000,0.300000,0.300000,69,55,14,true,1,14,234
ReactivePlayer,-15391,20,0.300000,0.300000,0.300000,16,9,7,true,1,7,95
ReactivePlayer,-100965,20,0.300000,0.300000,0.300000,100,81,19,false,0,19,259
ReactivePlayer,-100255,20,0.300000,0.300000,0.300000,99,78,21,false,0,21,250
ReactivePlayer,-100658,20,0.300000,0.300000,0.300000,99,85,14,false,0,14,219
ReactivePlayer,-100205,20,0.300000,0.300000,0.300000,99,94,5,false,0,5,91
ReactivePlayer,-100363,20,0.300000,0.300000,0.300000,99,75,24,false,0,24,274
ReactivePlayer,-57883,20,0.300000,0.300000,0.300000,58,46,12,true,1,12,182
ReactivePlayer,-100693,20,0.300000,0.300000,0.300000,100,94,6,false,0,6,61
ReactivePlayer,-100918,20,0.300000,0.300000,0.300000,100,80,20,false,0,20,220
ReactivePlayer,-100019,20,0.300000,0.300000,0.300000,99,91,8,false,0,8,181
ReactivePlayer,-66,20,0.300000,0.300000,0.300000,1,1,0,true,1,0,20
ReactivePlayer,-100307,20,0.300000,0.300000,0.300000,99,72,27,false,0,27,243
ReactivePlayer,-100156,20,0.300000,0.300000,0.300000,99,79,20,false,0,20,272
ReactivePlayer,-100251,20,0.300000,0.300000,0.300000,99,79,20,false,0,20,235
ReactivePlayer,-100760,20,0.300000,0.300000,0.300000,100,92,8,false,0,8,91
ReactivePlayer,-22235,20,0.300000,0.300000,0.300000,23,21,2,true,1,2,73
ReactivePlayer,-100813,20,0.300000,0.300000,0.300000,99,81,18,false,0,18,240
ReactivePlayer,-59038,20,0.300000,0.300000,0.300000,59,54,5,true,1,5,147
ReactivePlayer,-100846,20,0.300000,0.300000,0.300000,100,80,20,false,0,20,267
ReactivePlayer,-100366,20,0.300000,0.300000,0.300000,99,82,17,false,0,17,224
ReactivePlayer,-100800,20,0.300000,0.300000,0.300000,98,72,26,false,0,26,231
ReactivePlayer,-100395,20,0.300000,0.300000,0.300000,99,86,13,false,0,13,284
ReactivePlayer,-17122,20,0.300000,0.300000,0.300000,18,15,3,true,1,3,47
ReactivePlayer,-100087,20,0.300000,0.300000,0.300000,98,73,25,false,0,25,285
ReactivePlayer,-100047,20,0.300000,0.300000,0.300000,99,78,21,false,0,21,194
ReactivePlayer,-86681,20,0.300000,0.300000,0.300000,87,67,20,true,1,20,201
ReactivePlayer,-100821,20,0.300000,0.300000,0.300000,100,94,6,false,0,6,98
ReactivePlayer,-100766,20,0.300000,0.300000,0.300000,99,78,21,false,0,21,275
ReactivePlayer,-100164,20,0.300000,0.300000,0.300000,99,88,11,false,0,11,198
ReactivePlayer,-59802,20,0.300000,0.300000,0.300000,60,49,11,true,1,11,200
ReactivePlayer,-100294,20,0.300000,0.300000,0.300000,99,84,15,false,0,15,220
ReactivePlayer,-100332,20,0.300000,0.300000,0.300000,99,85,14,false,0,14,293
ReactivePlayer,-19219,20,0.300000,0.300000,0.300000,20,14,6,true,1,6,82
ReactivePlayer,-100227,20,0.300000,0.300000,0.300000,99,83,16,false,0,16,223
ReactivePlayer,-100743,20,0.300000,0.300000,0.300000,100,90,10,false,0,10,164
ReactivePlayer,-29607,20,0.300000,0.300000,0.300000,30,21,9,true,1,9,116
ReactivePlayer,-100903,20,0.300000,0.300000,0.300000,100,89,11,false,0,11,201
ReactivePlayer,-15170,20,0.300000,0.300000,0.300000,16,9,7,true,1,7,65
ReactivePlayer,-12384,20,0.300000,0.300000,0.300000,13,7,6,true,1,6,56
ReactivePlayer,-100236,20,0.300000,0.300000,0.300000,99,88,11,false,0,11,137
ReactivePlayer,-9101,20,0.300000,0.300000,0.300000,10,8,2,true,1,2,31
ReactivePlayer,-21427,20,0.300000,0.300000,0.300000,22,16,6,true,1,6,102
ReactivePlayer,-35396,20,0.300000,0.300000,0.300000,36,28,8,true,1,8,107
ReactivePlayer,-100842,20,0.300000,0.300000,0.300000,99,80,19,false,0,19,309
ReactivePlayer,-62613,20,0.300000,0.300000,0.300000,63,52,11,true,1,11,200
ReactivePlayer,-74893,20,0.300000,0.300000,0.300000,75,61,14,true,1,14,169
ReactivePlayer,-75048,20,0.300000,0.300000,0.300000,75,69,6,true,1,6,123
ReactivePlayer,-54646,20,0.300000,0.300000,0.300000,55,48,7,true,1,7,166
ReactivePlayer,-100858,20,0.300000,0.300000,0.300000,100,81,19,false,0,19,232
ReactivePlayer,-22400,20,0.300000,0.300000,0.300000,23,19,4,true,1,4,105
ReactivePlayer,-100098,20,0.300000,0.300000,0.300000,99,88,11,false,0,11,132
ReactivePlayer,-100992,20,0.300000,0.300000,0.300000,100,88,12,false,0,12,229
ReactivePlayer,-100000,20,0.300000,0.300000,0.300000,99,82,17,false,0,17,235
ReactivePlayer,-100535,20,0.300000,0.300000,0.300000,99,82,17,false,0,17,309
ReactivePlayer,-71220,20,0.300000,0.300000,0.300000,71,59,12,true,1,12,247
ReactivePlayer,-13247,20,0.300000,0.300000,0.300000,14,7,7,true,1,7,87
ReactivePlayer,-91070,20,0.300000,0.300000,0.300000,91,76,15,true,1,15,266
ReactivePlayer,-100170,20,0.300000,0.300000,0.300000,99,90,9,false,0,9,128
ReactivePlayer,-100066,20,0.300000,0.300000,0.300000,99,79,20,false,0,20,175
ReactivePlayer,-100038,20,0.300000,0.300000,0.300000,99,79,20,false,0,20,190
ReactivePlayer,-100656,20,0.300000,0.300000,0.300000,99,83,16,false,0,16,224
ReactivePlayer,-49085,20,0.300000,0.300000,0.300000,49,34,15,true,1,15,204
ReactivePlayer,-10137,20,0.300000,0.300000,0.300000,11,8,3,true,1,3,40
ReactivePlayer,-12245,20,0.300000,0.300000,0.300000,13,6,7,true,1,7,87
ReactivePlayer,-100058,20,0.300000,0.300000,0.300000,99,91,8,false,0,8,195
ReactivePlayer,-100371,20,0.300000,0.300000,0.300000,99,81,18,false,0,18,238
ReactivePlayer,-98297,20,0.300000,0.300000,0.300000,98,76,22,true,1,22,185
ReactivePlayer,-100187,20,0.300000,0.300000,0.300000,99,88,11,false,0,11,239
ReactivePlayer,-33239,20,0.300000,0.300000,0.300000,34,25,9,true,1,9,99
ReactivePlayer,-55014,20,0.300000,0.300000,0.300000,55,50,5,true,1,5,126
ReactivePlayer,-93670,20,0.300000,0.300000,0.300000,93,71,22,true,1,22,283
ReactivePlayer,-100350,20,0.300000,0.300000,0.300000,99,86,13,false,0,13,208
ReactivePlayer,-11315,20,0.300000,0.300000,0.300000,12,6,6,true,1,6,61
ReactivePlayer,-67903,20,0.300000,0.300000,0.300000,68,61,7,true,1,7,172
ReactivePlayer,-93668,20,0.300000,0.300000,0.300000,94,79,15,true,1,15,192
ReactivePlayer,-100387,20,0.300000,0.300000,0.300000,99,86,13,false,0,13,161
ReactivePlayer,-100049,20,0.300000,0.300000,0.300000,99,82,17,false,0,17,246
ReactivePlayer,-30430,20,0.300000,0.300000,0.300000,31,21,10,true,1,10,152
ReactivePlayer,-100049,20,0.300000,0.300000,0.300000,99,82,17,false,0,17,247
ReactivePlayer,-75029,20,0.300000,0.300000,0.300000,75,61,14,true,1,14,148
ReactivePlayer,-100000,20,0.300000,0.300000,0.300000,99,76,23,false,0,23,281
ReactivePlayer,-100018,20,0.300000,0.300000,0.300000,99,88,11,false,0,11,183
ReactivePlayer,-100031,20,0.300000,0.300000,0.300000,99,88,11,false,0,11,190
ReactivePlayer,-68153,20,0.300000,0.300000,0.300000,68,61,7,true,1,7,87
ReactivePlayer,-28200,20,0.300000,0.300000,0.300000,29,17,12,true,1,12,99
ReactivePlayer,-100619,20,0.300000,0.300000,0.300000,99,75,24,false,0,24,306
ReactivePlayer,-100938,20,0.300000,0.300000,0.300000,100,84,16,false,0,16,215
ReactivePlayer,-100855,20,0.300000,0.300000,0.300000,100,87,13,false,0,13,122
ReactivePlayer,-100394,20,0.300000,0.300000,0.300000,99,73,26,false,0,26,249
ReactivePlayer,-47887,20,0.300000,0.300000,0.300000,47,21,26,true,1,26,300
ReactivePlayer,-100308,20,0.300000,0.300000,0.300000,99,72,27,false,0,27,254
ReactivePlayer,-72210,20,0.300000,0.300000,0.300000,72,57,15,true,1,15,206
ReactivePlayer,-100945,20,0.300000,0.300000,0.300000,100,79,21,false,0,21,199
ReactivePlayer,-100259,20,0.300000,0.300000,0.300000,99,91,8,false,0,8,195
ReactivePlayer,-100723,20,0.300000,0.300000,0.300000,99,82,17,false,0,17,255
ReactivePlayer,-100672,20,0.300000,0.300000,0.300000,99,84,15,false,0,15,204
ReactivePlayer,-28567,20,0.300000,0.300000,0.300000,29,18,11,true,1,11,128
ReactivePlayer,-100608,20,0.300000,0.300000,0.300000,100,94,6,false,0,6,83
ReactivePlayer,-100367,20,0.300000,0.300000,0.300000,99,85,14,false,0,14,229
ReactivePlayer,-29518,20,0.300000,0.300000,0.300000,30,12,18,true,1,18,181
ReactivePlayer,998,20,0.300000,0.300000,0.300000,0,0,0,true,1,0,2
ReactivePlayer,-100671,20,0.300000,0.300000,0.300000,100,90,10,false,0,10,162
ReactivePlayer,-100714,20,0.300000,0.300000,0.300000,100,85,15,false,0,15,205
ReactivePlayer,-100047,20,0.300000,0.300000,0.300000,99,73,26,false,0,26,244
ReactivePlayer,-100430,20,0.300000,0.300000,0.300000,99,84,15,false,0,15,277
ReactivePlayer,-63574,20,0.300000,0.300000,0.300000,64,54,10,true,1,10,163
ReactivePlayer,-13127,20,0.300000,0.300000,0.300000,14,10,4,true,1,4,53
ReactivePlayer,-100926,20,0.300000,0.300000,0.300000,100,86,14,false,0,14,203
ReactivePlayer,-100044,20,0.300000,0.300000,0.300000,99,80,19,false,0,19,206
ReactivePlayer,-100019,20,0.300000,0.300000,0.300000,99,78,21,false,0,21,243
ReactivePlayer,-100511,20,0.300000,0.300000,0.300000,99,87,12,false,0,12,281
ReactivePlayer,-100818,20,0.300000,0.300000,0.300000,100,88,12,false,0,12,200
ReactivePlayer,-86443,20,0.300000,0.300000,0.300000,86,72,14,true,1,14,223
ReactivePlayer,-100230,20,0.300000,0.300000,0.300000,98,76,22,false,0,22,233
ReactivePlayer,-45025,20,0.300000,0.300000,0.300000,45,32,13,true,1,13,205
ReactivePlayer,-100645,20,0.300000,0.300000,0.300000,99,79,20,false,0,20,243
ReactivePlayer,-6109,20,0.300000,0.300000,0.300000,7,2,5,true,1,5,39
ReactivePlayer,-100847,20,0.300000,0.300000,0.300000,99,83,16,false,0,16,208
ReactivePlayer,-100427,20,0.300000,0.300000,0.300000,99,83,16,false,0,16,227
ReactivePlayer,-78214,20,0.300000,0.300000,0.300000,78,66,12,true,1,12,240
ReactivePlayer,-3351,20,0.300000,0.300000,0.300000,4,1,3,true,1,3,68
ReactivePlayer,-37329,20,0.300000,0.300000,0.300000,38,30,8,true,1,8,133
ReactivePlayer,-42426,20,0.300000,0.300000,0.300000,43,33,10,true,1,10,124
ReactivePlayer,-100589,20,0.300000,0.300000,0.300000,99,81,18,false,0,18,259
ReactivePlayer,-100854,20,0.300000,0.300000,0.300000,100,84,16,false,0,16,179
ReactivePlayer,-2012,20,0.300000,0.300000,0.300000,3,2,1,true,1,1,5
ReactivePlayer,-65917,20,0.300000,0.300000,0.300000,66,47,19,true,1,19,180
ReactivePlayer,-100394,20,0.300000,0.300000,0.300000,99,88,11,false,0,11,231
ReactivePlayer,-41331,20,0.300000,0.300000,0.300000,42,35,7,true,1,7,69
ReactivePlayer,-10078,20,0.300000,0.300000,0.300000,11,10,1,true,1,1,18
ReactivePlayer,-100048,20,0.300000,0.300000,0.300000,99,89,10,false,0,10,183
ReactivePlayer,-100992,20,0.300000,0.300000,0.300000,100,76,24,false,0,24,253
ReactivePlayer,-43863,20,0.300000,0.300000,0.300000,44,23,21,true,1,21,226
ReactivePlayer,-100309,20,0.300000,0.300000,0.300000,99,87,12,false,0,12,224
ReactivePlayer,-33262,20,0.300000,0.300000,0.300000,34,26,8,true,1,8,85
ReactivePlayer,-100153,20,0.300000,0.300000,0.300000,99,81,18,false,0,18,200
ReactivePlayer,-18317,20,0.300000,0.300000,0.300000,19,10,9,true,1,9,129
ReactivePlayer,-95096,20,0.300000,0.300000,0.300000,95,81,14,true,1,14,206
ReactivePlayer,-100842,20,0.300000,0.300000,0.300000,100,78,22,false,0,22,208
ReactivePlayer,-14396,20,0.300000,0.300000,0.300000,15,7,8,true,1,8,121
ReactivePlayer,-100461,20,0.300000,0.300000,0.300000,99,81,18,false,0,18,258
ReactivePlayer,-100122,20,0.300000,0.300000,0.300000,99,85,14,false,0,14,193
ReactivePlayer,-15245,20,0.300000,0.300000,0.300000,16,11,5,true,1,5,61
ReactivePlayer,-35182,20,0.300000,0.300000,0.300000,36,27,9,true,1,9,82
ReactivePlayer,-100943,20,0.300000,0.300000,0.300000,100,94,6,false,0,6,132
ReactivePlayer,-100961,20,0.300000,0.300000,0.300000,100,80,20,false,0,20,236
ReactivePlayer,-67141,20,0.300000,0.300000,0.300000,67,59,8,true,1,8,166
ReactivePlayer,-100584,20,0.300000,0.300000,0.300000,99,88,11,false,0,11,225
ReactivePlayer,-100083,20,0.300000,0.300000,0.300000,99,90,9,false,0,9,165
ReactivePlayer,-10067,20,0.300000,0.300000,0.300000,11,5,6,true,1,6,43
ReactivePlayer,-100131,20,0.300000,0.300000,0.300000,99,82,17,false,0,17,238
ReactivePlayer,-100726,20,0.300000,0.300000,0.300000,99,80,19,false,0,19,311
ReactivePlayer,-2023,20,0.300000,0.300000,0.300000,3,2,1,true,1,1,15
ReactivePlayer,-100264,20,0.300000,0.300000,0.300000,99,86,13,false,0,13,197
ReactivePlayer,-100348,20,0.300000,0.300000,0.300000,99,85,14,false,0,14,253
ReactivePlayer,-100151,20,0.300000,0.300000,0.300000,99,76,23,false,0,23,220
ReactivePlayer,-69766,20,0.300000,0.300000,0.300000,70,55,15,true,1,15,132
ReactivePlayer,-29325,20,0.300000,0.300000,0.300000,30,23,7,true,1,7,83
ReactivePlayer,-100005,20,0.300000,0.300000,0.300000,99,87,12,false,0,12,246
ReactivePlayer,-100812,20,0.300000,0.300000,0.300000,100,78,22,false,0,22,189
ReactivePlayer,-85177,20,0.300000,0.300000,0.300000,85,69,16,true,1,16,222
ReactivePlayer,-100857,20,0.300000,0.300000,0.300000,99,90,9,false,0,9,173
ReactivePlayer,-100824,20,0.300000,0.300000,0.300000,100,91,9,false,0,9,131
ReactivePlayer,-25434,20,0.300000,0.300000,0.300000,26,12,14,true,1,14,159
ReactivePlayer,-29255,20,0.300000,0.300000,0.300000,30,19,11,true,1,11,85
ReactivePlayer,-67702,20,0.300000,0.300000,0.300000,67,48,19,true,1,19,236
ReactivePlayer,-100045,20,0.300000,0.300000,0.300000,99,85,14,false,0,14,241
ReactivePlayer,-78043,20,0.300000,0.300000,0.300000,78,59,19,true,1,19,234
ReactivePlayer,-100003,20,0.300000,0.300000,0.300000,99,84,15,false,0,15,201
ReactivePlayer,-15503,20,0.300000,0.300000,0.300000,16,9,7,true,1,7,99
ReactivePlayer,-100413,20,0.300000,0.300000,0.300000,99,80,19,false,0,19,272
ReactivePlayer,-100457,20,0.300000,0.300000,0.300000,99,92,7,false,0,7,165
ReactivePlayer,-100968,20,0.300000,0.300000,0.300000,100,85,15,false,0,15,194
ReactivePlayer,-48497,20,0.300000,0.300000,0.300000,49,37,12,true,1,12,146
ReactivePlayer,-56415,20,0.300000,0.300000,0.300000,57,50,7,true,1,7,97
ReactivePlayer,-50574,20,0.300000,0.300000,0.300000,51,40,11,true,1,11,106
ReactivePlayer,-100067,20,0.300000,0.300000,0.300000,99,83,16,false,0,16,178
ReactivePlayer,-58385,20,0.300000,0.300000,0.300000,59,47,12,true,1,12,103
ReactivePlayer,-100434,20,0.300000,0.300000,0.300000,99,82,17,false,0,17,212
ReactivePlayer,-100304,20,0.300000,0.300000,0.300000,99,82,17,false,0,17,225
ReactivePlayer,-64704,20,0.300000,0.300000,0.300000,65,45,20,true,1,20,219
ReactivePlayer,-16117,20,0.300000,0.300000,0.300000,17,16,1,true,1,1,18
ReactivePlayer,-100025,20,0.300000,0.300000,0.300000,99,84,15,false,0,15,201
ReactivePlayer,-6060,20,0.300000,0.300000,0.300000,7,2,5,true,1,5,36
ReactivePlayer,-58114,20,0.300000,0.300000,0.300000,58,43,15,true,1,15,191
ReactivePlayer,-100676,20,0.300000,0.300000,0.300000,100,100,0,false,0,0,2
ReactivePlayer,-34185,20,0.300000,0.300000,0.300000,34,25,9,true,1,9,157
ReactivePlayer,-100858,20,0.300000,0.300000,0.300000,100,91,9,false,0,9,139
ReactivePlayer,-64061,20,0.300000,0.300000,0.300000,64,40,24,true,1,24,236
ReactivePlayer,-13316,20,0.300000,0.300000,0.300000,14,7,7,true,1,7,113
ReactivePlayer,-100578,20,0.300000,0.300000,0.300000,99,78,21,false,0,21,247
ReactivePlayer,-100940,20,0.300000,0.300000,0.300000,99,70,29,false,0,29,316
ReactivePlayer,-100000,20,0.300000,0.300000,0.300000,99,86,13,false,0,13,224
ReactivePlayer,-100414,20,0.300000,0.300000,0.300000,99,73,26,false,0,26,261
ReactivePlayer,-45534,20,0.300000,0.300000,0.300000,46,41,5,true,1,5,125
ReactivePlayer,-64455,20,0.300000,0.300000,0.300000,65,56,9,true,1,9,127
ReactivePlayer,-25259,20,0.300000,0.300000,0.300000,26,20,6,true,1,6,84
ReactivePlayer,-6084,20,0.300000,0.300000,0.300000,7,6,1,true,1,1,41
ReactivePlayer,997,20,0.300000,0.300000,0.300000,0,0,0,true,1,0,3
ReactivePlayer,-100425,20,0.300000,0.300000,0.300000,99,78,21,false,0,21,185
ReactivePlayer,-100887,20,0.300000,0.300000,0.300000,100,91,9,false,0,9,180
ReactivePlayer,-100688,20,0.300000,0.300000,0.300000,100,90,10,false,0,10,133
ReactivePlayer,-100846,20,0.300000,0.300000,0.300000,100,86,14,false,0,14,172
ReactivePlayer,-100326,20,0.300000,0.300000,0.300000,99,94,5,false,0,5,167
ReactivePlayer,-100493,20,0.300000,0.300000,0.300000,99,82,17,false,0,17,202
ReactivePlayer,-50403,20,0.300000,0.300000,0.300000,51,40,11,true,1,11,127
ReactivePlayer,-100043,20,0.300000,0.300000,0.300000,99,85,14,false,0,14,195
ReactivePlayer,-100348,20,0.300000,0.300000,0.300000,99,91,8,false,0,8,150
ReactivePlayer,-18176,20,0.300000,0.300000,0.300000,19,14,5,true,1,5,48
ReactivePlayer,-93888,20,0.300000,0.300000,0.300000,94,78,16,true,1,16,214
ReactivePlayer,-100000,20,0.300000,0.300000,0.300000,99,85,14,false,0,14,105
ReactivePlayer,-100139,20,0.300000,0.300000,0.300000,99,86,13,false,0,13,201
ReactivePlayer,-80820,20,0.300000,0.300000,0.300000,81,68,13,true,1,13,180
ReactivePlayer,-78658,20,0.300000,0.300000,0.300000,79,72,7,true,1,7,136
ReactivePlayer,-95666,20,0.300000,0.300000,0.300000,96,82,14,true,1,14,186
ReactivePlayer,-100873,20,0.300000,0.300000,0.300000,99,76,23,false,0,23,286
ReactivePlayer,-100891,20,0.300000,0.300000,0.300000,100,87,13,false,0,13,233
ReactivePlayer,-60582,20,0.300000,0.300000,0.300000,61,51,10,true,1,10,133
ReactivePlayer,-100893,20,0.300000,0.300000,0.300000,100,82,18,false,0,18,181
ReactivePlayer,-24638,20,0.300000,0.300000,0.300000,25,18,7,true,1,7,117
ReactivePlayer,-59674,20,0.300000,0.300000,0.300000,60,49,11,true,1,11,134
ReactivePlayer,-100360,20,0.300000,0.300000,0.300000,99,86,13,false,0,13,165
ReactivePlayer,-100740,20,0.300000,0.300000,0.300000,100,92,8,false,0,8,102
ReactivePlayer,-6116,20,0.300000,0.300000,0.300000,7,5,2,true,1,2,50
ReactivePlayer,-71504,20,0.300000,0.300000,0.300000,72,61,11,true,1,11,130
ReactivePlayer,-35080,20,0.300000,0.300000,0.300000,35,24,11,true,1,11,171
ReactivePlayer,-83907,20,0.300000,0.300000,0.300000,84,65,19,true,1,19,190
ReactivePlayer,-100682,20,0.300000,0.300000,0.300000,99,83,16,false,0,16,267
ReactivePlayer,-100000,20,0.300000,0.300000,0.300000,98,77,21,false,0,21,204
ReactivePlayer,-100951,20,0.300000,0.300000,0.300000,100,89,11,false,0,11,173
ReactivePlayer,-100994,20,0.300000,0.300000,0.300000,98,78,20,false,0,20,232
ReactivePlayer,-100776,20,0.300000,0.300000,0.300000,100,89,11,false,0,11,136
ReactivePlayer,-100705,20,0.300000,0.300000,0.300000,99,80,19,false,0,19,253
ReactivePlayer,-4041,20,0.300000,0.300000,0.300000,5,3,2,true,1,2,28
ReactivePlayer,-4151,20,0.300000,0.300000,0.300000,5,1,4,true,1,4,47
ReactivePlayer,-54550,20,0.300000,0.300000,0.300000,55,44,11,true,1,11,157
ReactivePlayer,-100416,20,0.300000,0.300000,0.300000,99,82,17,false,0,17,215
ReactivePlayer,-7140,20,0.300000,0.300000,0.300000,8,5,3,true,1,3,70
ReactivePlayer,-100341,20,0.300000,0.300000,0.300000,99,85,14,false,0,14,215
ReactivePlayer,-100000,20,0.300000,0.300000,0.300000,98,85,13,false,0,13,229
ReactivePlayer,-100188,20,0.300000,0.300000,0.300000,99,86,13,false,0,13,193
ReactivePlayer,-100558,20,0.300000,0.300000,0.300000,99,81,18,false,0,18,193
ReactivePlayer,-66445,20,0.300000,0.300000,0.300000,67,61,6,true,1,6,99
ReactivePlayer,-100862,20,0.300000,0.300000,0.300000,100,86,14,false,0,14,238
ReactivePlayer,-100073,20,0.300000,0.300000,0.300000,98,76,22,false,0,22,324
ReactivePlayer,-100169,20,0.300000,0.300000,0.300000,99,84,15,false,0,15,193
ReactivePlayer,-100299,20,0.300000,0.300000,0.300000,99,81,18,false,0,18,214
ReactivePlayer,-10222,20,0.300000,0.300000,0.300000,11,8,3,true,1,3,76
ReactivePlayer,-100067,20,0.300000,0.300000,0.300000,99,85,14,false,0,14,164
ReactivePlayer,-22354,20,0.300000,0.300000,0.300000,23,15,8,true,1,8,96
ReactivePlayer,-52573,20,0.300000,0.300000,0.300000,53,43,10,true,1,10,155
ReactivePlayer,-32300,20,0.300000,0.300000,0.300000,33,26,7,true,1,7,76
ReactivePlayer,-100787,20,0.300000,0.300000,0.300000,100,90,10,false,0,10,159
ReactivePlayer,-100922,20,0.300000,0.300000,0.300000,100,94,6,false,0,6,93
ReactivePlayer,-100611,20,0.300000,0.300000,0.300000,100,86,14,false,0,14,186
ReactivePlayer,-1023,20,0.300000,0.300000,0.300000,2,2,0,true,1,0,9
ReactivePlayer,-100134,20,0.300000,0.300000,0.300000,99,88,11,false,0,11,190
ReactivePlayer,-18373,20,0.300000,0.300000,0.300000,19,12,7,true,1,7,75
ReactivePlayer,-100912,20,0.300000,0.300000,0.300000,100,84,16,false,0,16,175
ReactivePlayer,-100622,20,0.300000,0.300000,0.300000,99,81,18,false,0,18,222
ReactivePlayer,-100800,20,0.300000,0.300000,0.300000,99,74,25,false,0,25,285
ReactivePlayer,-39505,20,0.300000,0.300000,0.300000,40,32,8,true,1,8,77
ReactivePlayer,-100951,20,0.300000,0.300000,0.300000,100,83,17,false,0,17,210
ReactivePlayer,-5039,20,0.300000,0.300000,0.300000,6,4,2,true,1,2,23
ReactivePlayer,-93281,20,0.300000,0.300000,0.300000,93,78,15,true,1,15,234
ReactivePlayer,-100001,20,0.300000,0.300000,0.300000,99,80,19,false,0,19,277
ReactivePlayer,-100430,20,0.300000,0.300000,0.300000,99,75,24,false,0,24,291
ReactivePlayer,-100990,20,0.300000,0.300000,0.300000,100,84,16,false,0,16,215
ReactivePlayer,-100956,20,0.300000,0.300000,0.300000,100,92,8,false,0,8,168
ReactivePlayer,-100117,20,0.300000,0.300000,0.300000,99,82,17,false,0,17,252
ReactivePlayer,-83090,20,0.300000,0.300000,0.300000,83,69,14,true,1,14,210
ReactivePlayer,-3033,20,0.300000,0.300000,0.300000,4,4,0,true,1,0,23
ReactivePlayer,-100090,20,0.300000,0.300000,0.300000,99,76,23,false,0,23,237
ReactivePlayer,-3402,20,0.300000,0.300000,0.300000,4,1,3,true,1,3,75
ReactivePlayer,-19303,20,0.300000,0.300000,0.300000,20,11,9,true,1,9,97
ReactivePlayer,-83490,20,0.300000,0.300000,0.300000,83,72,11,true,1,11,208
ReactivePlayer,-26394,20,0.300000,0.300000,0.300000,27,20,7,true,1,7,147
ReactivePlayer,-100815,20,0.300000,0.300000,0.300000,100,88,12,false,0,12,194
ReactivePlayer,-41609,20,0.300000,0.300000,0.300000,42,35,7,true,1,7,138
ReactivePlayer,-57710,20,0.300000,0.300000,0.300000,58,49,9,true,1,9,110
ReactivePlayer,-89618,20,0.300000,0.300000,0.300000,89,68,21,true,1,21,250
ReactivePlayer,-100482,20,0.300000,0.300000,0.300000,99,83,16,false,0,16,168
ReactivePlayer,-23503,20,0.300000,0.300000,0.300000,24,20,4,true,1,4,102
ReactivePlayer,-100724,20,0.300000,0.300000,0.300000,100,96,4,false,0,4,117
ReactivePlayer,-22134,20,0.300000,0.300000,0.300000,23,18,5,true,1,5,40
ReactivePlayer,-100587,20,0.300000,0.300000,0.300000,99,79,20,false,0,20,312
ReactivePlayer,-100908,20,0.300000,0.300000,0.300000,100,82,18,false,0,18,202
ReactivePlayer,-1008,20,0.300000,0.300000,0.300000,2,2,0,true,1,0,5
ReactivePlayer,-100299,20,0.300000,0.300000,0.300000,99,85,14,false,0,14,195
ReactivePlayer,-83256,20,0.300000,0.300000,0.300000,83,53,30,true,1,30,287
ReactivePlayer,-37277,20,0.300000,0.300000,0.300000,38,23,15,true,1,15,104
ReactivePlayer,-100637,20,0.300000,0.300000,0.300000,99,78,21,false,0,21,253
ReactivePlayer,-23194,20,0.300000,0.300000,0.300000,24,17,7,true,1,7,45
ReactivePlayer,-97478,20,0.300000,0.300000,0.300000,97,84,13,true,1,13,239
ReactivePlayer,-100374,20,0.300000,0.300000,0.300000,99,88,11,false,0,11,220
ReactivePlayer,-32331,20,0.300000,0.300000,0.300000,33,31,2,true,1,2,45
ReactivePlayer,-100707,20,0.300000,0.300000,0.300000,99,87,12,false,0,12,233
ReactivePlayer,-90727,20,0.300000,0.300000,0.300000,91,73,18,true,1,18,187
ReactivePlayer,-62564,20,0.300000,0.300000,0.300000,63,52,11,true,1,11,176
ReactivePlayer,-11145,20,0.300000,0.300000,0.300000,12,6,6,true,1,6,61
ReactivePlayer,-58996,20,0.300000,0.300000,0.300000,59,44,15,true,1,15,203
ReactivePlayer,-100998,20,0.300000,0.300000,0.300000,100,86,14,false,0,14,146
ReactivePlayer,-100735,20,0.300000,0.300000,0.300000,100,86,14,false,0,14,150
ReactivePlayer,-100210,20,0.300000,0.300000,0.300000,99,94,5,false,0,5,154
ReactivePlayer,-11318,20,0.300000,0.300000,0.300000,12,6,6,true,1,6,80
ReactivePlayer,-100322,20,0.300000,0.300000,0.300000,99,85,14,false,0,14,206
ReactivePlayer,-100528,20,0.300000,0.300000,0.300000,99,75,24,false,0,24,309
ReactivePlayer,-100524,20,0.300000,0.300000,0.300000,99,83,16,false,0,16,206
ReactivePlayer,-30417,20,0.300000,0.300000,0.300000,31,20,11,true,1,11,134
ReactivePlayer,-100227,20,0.300000,0.300000,0.300000,99,76,23,false,0,23,240
ReactivePlayer,-100181,20,0.300000,0.300000,0.300000,99,86,13,false,0,13,217
ReactivePlayer,-22158,20,0.300000,0.300000,0.300000,23,19,4,true,1,4,48
ReactivePlayer,-100295,20,0.300000,0.300000,0.300000,99,77,22,false,0,22,208
ReactivePlayer,-100342,20,0.300000,0.300000,0.300000,99,86,13,false,0,13,234
ReactivePlayer,-100873,20,0.300000,0.300000,0.300000,100,85,15,false,0,15,159
ReactivePlayer,-100176,20,0.300000,0.300000,0.300000,99,76,23,false,0,23,257
ReactivePlayer,-94981,20,0.300000,0.300000,0.300000,95,83,12,true,1,12,228
ReactivePlayer,-8161,20,0.300000,0.300000,0.300000,9,6,3,true,1,3,50
ReactivePlayer,-7045,20,0.300000,0.300000,0.300000,8,7,1,true,1,1,11
ReactivePlayer,-100229,20,0.300000,0.300000,0.300000,99,68,31,false,0,31,288
ReactivePlayer,-100463,20,0.300000,0.300000,0.300000,99,83,16,false,0,16,291
ReactivePlayer,-67622,20,0.300000,0.300000,0.300000,68,56,12,true,1,12,133
ReactivePlayer,-100166,20,0.300000,0.300000,0.300000,99,85,14,false,0,14,186
ReactivePlayer,-100841,20,0.300000,0.300000,0.300000,100,86,14,false,0,14,224
ReactivePlayer,-100153,20,0.300000,0.300000,0.300000,99,80,19,false,0,19,233
ReactivePlayer,-100936,20,0.300000,0.300000,0.300000,100,93,7,false,0,7,201
ReactivePlayer,-93262,20,0.300000,0.300000,0.300000,93,79,14,true,1,14,230
ReactivePlayer,-48284,20,0.300000,0.300000,0.300000,49,44,5,true,1,5,58
ReactivePlayer,-100119,20,0.300000,0.300000,0.300000,99,87,12,false,0,12,161
ReactivePlayer,-100077,20,0.300000,0.300000,0.300000,99,79,20,false,0,20,237
ReactivePlayer,-10174,20,0.300000,0.300000,0.300000,11,10,1,true,1,1,63
ReactivePlayer,-19384,20,0.300000,0.300000,0.300000,20,9,11,true,1,11,95
ReactivePlayer,-100015,20,0.300000,0.300000,0.300000,99,81,18,false,0,18,175
ReactivePlayer,-100153,20,0.300000,0.300000,0.300000,99,90,9,false,0,9,220
ReactivePlayer,-100444,20,0.300000,0.300000,0.300000,99,76,23,false,0,23,249
ReactivePlayer,-70906,20,0.300000,0.300000,0.300000,71,58,13,true,1,13,187
ReactivePlayer,-38352,20,0.300000,0.300000,0.300000,39,31,8,true,1,8,71
ReactivePlayer,-100405,20,0.300000,0.300000,0.300000,99,77,22,false,0,22,246
ReactivePlayer,-72555,20,0.300000,0.300000,0.300000,72,52,20,true,1,20,262
ReactivePlayer,-1009,20,0.300000,0.300000,0.300000,2,1,1,true,1,1,7
ReactivePlayer,-43666,20,0.300000,0.300000,0.300000,44,36,8,true,1,8,121
ReactivePlayer,-100129,20,0.300000,0.300000,0.300000,99,78,21,false,0,21,230
ReactivePlayer,-79621,20,0.300000,0.300000,0.300000,80,63,17,true,1,17,189
ReactivePlayer,-100301,20,0.300000,0.300000,0.300000,99,71,28,false,0,28,289
ReactivePlayer,-89521,20,0.300000,0.300000,0.300000,89,71,18,true,1,18,257
ReactivePlayer,-100334,20,0.300000,0.300000,0.300000,99,82,17,false,0,17,277
ReactivePlayer,-82389,20,0.300000,0.300000,0.300000,82,60,22,true,1,22,240
ReactivePlayer,-100249,20,0.300000,0.300000,0.300000,99,92,7,false,0,7,218
ReactivePlayer,-100063,20,0.300000,0.300000,0.300000,99,84,15,false,0,15,233
ReactivePlayer,-13114,20,0.300000,0.300000,0.300000,14,8,6,true,1,6,51
ReactivePlayer,-100813,20,0.300000,0.300000,0.300000,100,91,9,false,0,9,146
ReactivePlayer,-100086,20,0.300000,0.300000,0.300000,99,80,19,false,0,19,230
ReactivePlayer,-3037,20,0.300000,0.300000,0.300000,4,1,3,true,1,3,25
ReactivePlayer,-100134,20,0.300000,0.300000,0.300000,99,86,13,false,0,13,244
ReactivePlayer,-56494,20,0.300000,0.300000,0.300000,57,46,11,true,1,11,147
ReactivePlayer,-17193,20,0.300000,0.300000,0.300000,18,15,3,true,1,3,75
ReactivePlayer,-100012,20,0.300000,0.300000,0.300000,99,80,19,false,0,19,231
ReactivePlayer,-100317,20,0.300000,0.300000,0.300000,99,82,17,false,0,17,290
ReactivePlayer,-72666,20,0.300000,0.300000,0.300000,73,61,12,true,1,12,86
ReactivePlayer,-1036,20,0.300000,0.300000,0.300000,2,2,0,true,1,0,17
ReactivePlayer,-100096,20,0.300000,0.300000,0.300000,99,85,14,false,0,14,227
ReactivePlayer,-36390,20,0.300000,0.300000,0.300000,37,25,12,true,1,12,88
ReactivePlayer,-100068,20,0.300000,0.300000,0.300000,99,85,14,false,0,14,190
ReactivePlayer,-100756,20,0.300000,0.300000,0.300000,100,88,12,false,0,12,159
ReactivePlayer,-8357,20,0.300000,0.300000,0.300000,9,3,6,true,1,6,62
ReactivePlayer,-100286,20,0.300000,0.300000,0.300000,99,82,17,false,0,17,218
ReactivePlayer,-49601,20,0.300000,0.300000,0.300000,50,45,5,true,1,5,135
ReactivePlayer,-17311,20,0.300000,0.300000,0.300000,18,13,5,true,1,5,132
ReactivePlayer,-100028,20,0.300000,0.300000,0.300000,99,90,9,false,0,9,178
ReactivePlayer,-38617,20,0.300000,0.300000,0.300000,39,27,12,true,1,12,167
ReactivePlayer,-27471,20,0.300000,0.300000,0.300000,28,16,12,true,1,12,125
ReactivePlayer,-66586,20,0.300000,0.300000,0.300000,67,60,7,true,1,7,116
ReactivePlayer,-100482,20,0.300000,0.300000,0.300000,100,90,10,false,0,10,121
ReactivePlayer,-100222,20,0.300000,0.300000,0.300000,99,77,22,false,0,22,284
ReactivePlayer,-100197,20,0.300000,0.300000,0.300000,98,72,26,false,0,26,325
ReactivePlayer,-100333,20,0.300000,0.300000,0.300000,99,81,18,false,0,18,263
ReactivePlayer,-38509,20,0.300000,0.300000,0.300000,39,32,7,true,1,7,117
ReactivePlayer,-19431,20,0.300000,0.300000,0.300000,20,14,6,true,1,6,97
ReactivePlayer,-100987,20,0.300000,0.300000,0.300000,99,85,14,false,0,14,307
ReactivePlayer,-100471,20,0.300000,0.300000,0.300000,99,87,12,false,0,12,247
ReactivePlayer,-1054,20,0.300000,0.300000,0.300000,2,0,2,true,1,2,21
ReactivePlayer,-100071,20,0.300000,0.300000,0.300000,99,88,11,false,0,11,208
ReactivePlayer,-100957,20,0.300000,0.300000,0.300000,100,81,19,false,0,19,241
ReactivePlayer,-100111,20,0.300000,0.300000,0.300000,99,79,20,false,0,20,246
ReactivePlayer,-100171,20,0.300000,0.300000,0.300000,99,87,12,false,0,12,152
ReactivePlayer,-14325,20,0.300000,0.300000,0.300000,15,11,4,true,1,4,110
ReactivePlayer,-22510,20,0.300000,0.300000,0.300000,23,16,7,true,1,7,112
ReactivePlayer,-100289,20,0.300000,0.300000,0.300000,99,87,12,false,0,12,202
ReactivePlayer,-4057,20,0.300000,0.300000,0.300000,5,3,2,true,1,2,34
ReactivePlayer,-100335,20,0.300000,0.300000,0.300000,99,87,12,false,0,12,154
ReactivePlayer,-68525,20,0.300000,0.300000,0.300000,69,64,5,true,1,5,133
ReactivePlayer,-19275,20,0.300000,0.300000,0.300000,20,16,4,true,1,4,55
ReactivePlayer,-21763,20,0.300000,0.300000,0.300000,22,14,8,true,1,8,129
ReactivePlayer,-100256,20,0.300000,0.300000,0.300000,99,87,12,false,0,12,199
ReactivePlayer,-14165,20,0.300000,0.300000,0.300000,15,11,4,true,1,4,37
ReactivePlayer,-100215,20,0.300000,0.300000,0.300000,99,79,20,false,0,20,218
ReactivePlayer,-3149,20,0.300000,0.300000,0.300000,4,2,2,true,1,2,54
ReactivePlayer,-100791,20,0.300000,0.300000,0.300000,100,89,11,false,0,11,153
ReactivePlayer,-16192,20,0.300000,0.300000,0.300000,17,10,7,true,1,7,71
ReactivePlayer,-54710,20,0.300000,0.300000,0.300000,55,47,8,true,1,8,145
ReactivePlayer,-2029,20,0.300000,0.300000,0.300000,3,1,2,true,1,2,17
ReactivePlayer,-100610,20,0.300000,0.300000,0.300000,99,84,15,false,0,15,196
ReactivePlayer,-100981,20,0.300000,0.300000,0.300000,100,84,16,false,0,16,157
ReactivePlayer,-22340,20,0.300000,0.300000,0.300000,23,17,6,true,1,6,69
ReactivePlayer,-35494,20,0.300000,0.300000,0.300000,36,32,4,true,1,4,73
ReactivePlayer,-100113,20,0.300000,0.300000,0.300000,99,78,21,false,0,21,184
ReactivePlayer,-100197,20,0.300000,0.300000,0.300000,98,79,19,false,0,19,243
ReactivePlayer,-48779,20,0.300000,0.300000,0.300000,49,35,14,true,1,14,234
ReactivePlayer,-18203,20,0.300000,0.300000,0.300000,19,15,4,true,1,4,45
ReactivePlayer,-35486,20,0.300000,0.300000,0.300000,36,31,5,true,1,5,115
ReactivePlayer,-26292,20,0.300000,0.300000,0.300000,27,18,9,true,1,9,101
ReactivePlayer,-100274,20,0.300000,0.300000,0.300000,99,79,20,false,0,20,240
ReactivePlayer,-38485,20,0.300000,0.300000,0.300000,39,27,12,true,1,12,135
ReactivePlayer,-49548,20,0.300000,0.300000,0.300000,50,41,9,true,1,9,138
ReactivePlayer,-23451,20,0.300000,0.300000,0.300000,24,14,10,true,1,10,138
ReactivePlayer,-100211,20,0.300000,0.300000,0.300000,99,82,17,false,0,17,229
ReactivePlayer,989,20,0.300000,0.300000,0.300000,0,0,0,true,1,0,9
ReactivePlayer,-14095,20,0.300000,0.300000,0.300000,15,11,4,true,1,4,48
ReactivePlayer,-100728,20,0.300000,0.300000,0.300000,99,78,21,false,0,21,299
ReactivePlayer,-100411,20,0.300000,0.300000,0.300000,99,85,14,false,0,14,233
ReactivePlayer,-50742,20,0.300000,0.300000,0.300000,51,36,15,true,1,15,190
ReactivePlayer,-20351,20,0.300000,0.300000,0.300000,21,11,10,true,1,10,135
ReactivePlayer,-100517,20,0.300000,0.300000,0.300000,99,86,13,false,0,13,212
ReactivePlayer,-100727,20,0.300000,0.300000,0.300000,100,88,12,false,0,12,144
ReactivePlayer,-10246,20,0.300000,0.300000,0.300000,11,7,4,true,1,4,113
ReactivePlayer,-100220,20,0.300000,0.300000,0.300000,99,84,15,false,0,15,225
ReactivePlayer,-18130,20,0.300000,0.300000,0.300000,19,14,5,true,1,5,51
ReactivePlayer,-5075,20,0.300000,0.300000,0.300000,6,2,4,true,1,4,31
ReactivePlayer,-100131,20,0.300000,0.300000,0.300000,99,80,19,false,0,19,306
ReactivePlayer,-77337,20,0.300000,0.300000,0.300000,77,67,10,true,1,10,164
ReactivePlayer,-93537,20,0.300000,0.300000,0.300000,93,72,21,true,1,21,296
ReactivePlayer,-12135,20,0.300000,0.300000,0.300000,13,7,6,true,1,6,59
ReactivePlayer,-100811,20,0.300000,0.300000,0.300000,100,95,5,false,0,5,112
ReactivePlayer,-8,20,0.300000,0.300000,0.300000,1,1,0,true,1,0,4
ReactivePlayer,-69869,20,0.300000,0.300000,0.300000,70,59,11,true,1,11,139
ReactivePlayer,-100000,20,0.300000,0.300000,0.300000,99,77,22,false,0,22,211
ReactivePlayer,-100195,20,0.300000,0.300000,0.300000,99,82,17,false,0,17,271
ReactivePlayer,-23369,20,0.300000,0.300000,0.300000,24,19,5,true,1,5,100
