Player Type,Total Score,World Size,Wumpus Probability,Obstacle Probability,Pit Probability,Total Deaths,Pit Deaths,Wumpus Deaths,Have gold,Have gold int,WumpusKilled,RoomsExplored
ReactivePlayer,-32447,15,0.300000,0.300000,0.300000,33,25,8,true,1,8,87
ReactivePlayer,-14273,15,0.300000,0.300000,0.300000,15,11,4,true,1,4,64
ReactivePlayer,-77162,15,0.300000,0.300000,0.300000,77,64,13,true,1,13,148
ReactivePlayer,-33495,15,0.300000,0.300000,0.300000,34,28,6,true,1,6,97
ReactivePlayer,-3050,15,0.300000,0.300000,0.300000,4,3,1,true,1,1,21
ReactivePlayer,-49615,15,0.300000,0.300000,0.300000,50,41,9,true,1,9,142
ReactivePlayer,-33892,15,0.300000,0.300000,0.300000,34,25,9,true,1,9,141
ReactivePlayer,-71591,15,0.300000,0.300000,0.300000,72,68,4,true,1,4,85
ReactivePlayer,-24379,15,0.300000,0.300000,0.300000,25,20,5,true,1,5,119
ReactivePlayer,-100303,15,0.300000,0.300000,0.300000,99,84,15,false,0,15,206
ReactivePlayer,-46449,15,0.300000,0.300000,0.300000,47,44,3,true,1,3,101
ReactivePlayer,-17303,15,0.300000,0.300000,0.300000,18,12,6,true,1,6,64
ReactivePlayer,-100896,15,0.300000,0.300000,0.300000,100,86,14,false,0,14,158
ReactivePlayer,-100649,15,0.300000,0.300000,0.300000,99,84,15,false,0,15,174
ReactivePlayer,-19169,15,0.300000,0.300000,0.300000,20,19,1,true,1,1,31
ReactivePlayer,-100103,15,0.300000,0.300000,0.300000,99,90,9,false,0,9,168
ReactivePlayer,-42753,15,0.300000,0.300000,0.300000,43,37,6,true,1,6,144
ReactivePlayer,-66971,15,0.300000,0.300000,0.300000,67,55,12,true,1,12,154
ReactivePlayer,-34369,15,0.300000,0.300000,0.300000,35,34,1,true,1,1,60
ReactivePlayer,-100946,15,0.300000,0.300000,0.300000,100,91,9,false,0,9,162
ReactivePlayer,-100100,15,0.300000,0.300000,0.300000,99,87,12,false,0,12,180
ReactivePlayer,-11139,15,0.300000,0.300000,0.300000,12,7,5,true,1,5,52
ReactivePlayer,-8172,15,0.300000,0.300000,0.300000,9,4,5,true,1,5,69
ReactivePlayer,-100606,15,0.300000,0.300000,0.300000,99,85,14,false,0,14,143
ReactivePlayer,-31230,15,0.300000,0.300000,0.300000,32,31,1,true,1,1,41
ReactivePlayer,-79860,15,0.300000,0.300000,0.300000,80,67,13,true,1,13,171
ReactivePlayer,-26437,15,0.300000,0.300000,0.300000,27,22,5,true,1,5,89
ReactivePlayer,-33409,15,0.300000,0.300000,0.300000,34,29,5,true,1,5,68
ReactivePlayer,-100604,15,0.300000,0.300000,0.300000,99,89,10,false,0,10,128
ReactivePlayer,-57507,15,0.300000,0.300000,0.300000,57,48,9,true,1,9,120
ReactivePlayer,-100471,15,0.300000,0.300000,0.300000,99,81,18,false,0,18,185
ReactivePlayer,-35406,15,0.300000,0.300000,0.300000,36,32,4,true,1,4,103
ReactivePlayer,-48608,15,0.300000,0.300000,0.300000,49,38,11,true,1,11,151
ReactivePlayer,-21235,15,0.300000,0.300000,0.300000,22,12,10,true,1,10,86
ReactivePlayer,-100341,15,0.300000,0.300000,0.300000,99,87,12,false,0,12,165
ReactivePlayer,-100135,15,0.300000,0.300000,0.300000,99,92,7,false,0,7,161
ReactivePlayer,-100994,15,0.300000,0.300000,0.300000,100,90,10,false,0,10,187
ReactivePlayer,-100166,15,0.300000,0.300000,0.300000,99,84,15,false,0,15,163
ReactivePlayer,-31623,15,0.300000,0.300000,0.300000,32,25,7,true,1,7,89
ReactivePlayer,-63698,15,0.300000,0.300000,0.300000,64,54,10,true,1,10,126
ReactivePlayer,-76199,15,0.300000,0.300000,0.300000,76,63,13,true,1,13,184
ReactivePlayer,-100393,15,0.300000,0.300000,0.300000,98,85,13,false,0,13,193
ReactivePlayer,-92236,15,0.300000,0.300000,0.300000,92,82,10,true,1,10,129
ReactivePlayer,-100018,15,0.300000,0.300000,0.300000,99,84,15,false,0,15,154
ReactivePlayer,-33274,15,0.300000,0.300000,0.300000,34,22,12,true,1,12,95
ReactivePlayer,-63980,15,0.300000,0.300000,0.300000,64,49,15,true,1,15,158
ReactivePlayer,-100446,15,0.300000,0.300000,0.300000,99,91,8,false,0,8,166
ReactivePlayer,-50801,15,0.300000,0.300000,0.300000,51,42,9,true,1,9,134
ReactivePlayer,-100183,15,0.300000,0.300000,0.300000,98,94,4,false,0,4,90
ReactivePlayer,-93194,15,0.300000,0.300000,0.300000,93,86,7,true,1,7,176
ReactivePlayer,-100975,15,0.300000,0.300000,0.300000,100,89,11,false,0,11,111
ReactivePlayer,-100833,15,0.300000,0.300000,0.300000,99,83,16,false,0,16,214
ReactivePlayer,-38974,15,0.300000,0.300000,0.300000,39,29,10,true,1,10,176
ReactivePlayer,-7066,15,0.300000,0.300000,0.300000,8,1,7,true,1,7,35
ReactivePlayer,-100534,15,0.300000,0.300000,0.300000,100,95,5,false,0,5,57
ReactivePlayer,-50606,15,0.300000,0.300000,0.300000,51,40,11,true,1,11,96
ReactivePlayer,-33523,15,0.300000,0.300000,0.300000,34,26,8,true,1,8,128
ReactivePlayer,-100102,15,0.300000,0.300000,0.300000,99,86,13,false,0,13,159
ReactivePlayer,-2069,15,0.300000,0.300000,0.300000,3,0,3,true,1,3,18
ReactivePlayer,-40498,15,0.300000,0.300000,0.300000,41,31,10,true,1,10,110
ReactivePlayer,-36423,15,0.300000,0.300000,0.300000,37,25,12,true,1,12,141
ReactivePlayer,-18220,15,0.300000,0.300000,0.300000,19,15,4,true,1,4,58
ReactivePlayer,-32488,15,0.300000,0.300000,0.300000,33,22,11,true,1,11,128
ReactivePlayer,-62113,15,0.300000,0.300000,0.300000,62,50,12,true,1,12,161
ReactivePlayer,-65553,15,0.300000,0.300000,0.300000,66,57,9,true,1,9,128
ReactivePlayer,-67794,15,0.300000,0.300000,0.300000,68,59,9,true,1,9,149
ReactivePlayer,-57035,15,0.300000,0.300000,0.300000,57,46,11,true,1,11,116
ReactivePlayer,-45752,15,0.300000,0.300000,0.300000,46,32,14,true,1,14,137
ReactivePlayer,-60085,15,0.300000,0.300000,0.300000,60,41,19,true,1,19,175
ReactivePlayer,-43025,15,0.300000,0.300000,0.300000,43,33,10,true,1,10,131
ReactivePlayer,-71823,15,0.300000,0.300000,0.300000,72,61,11,true,1,11,123
ReactivePlayer,-21111,15,0.300000,0.300000,0.300000,22,18,4,true,1,4,42
ReactivePlayer,-15155,15,0.300000,0.300000,0.300000,16,9,7,true,1,7,52
ReactivePlayer,-4170,15,0.300000,0.300000,0.300000,5,3,2,true,1,2,31
ReactivePlayer,-100939,15,0.300000,0.300000,0.300000,100,92,8,false,0,8,159
ReactivePlayer,-6083,15,0.300000,0.300000,0.300000,7,4,3,true,1,3,45
ReactivePlayer,-100078,15,0.300000,0.300000,0.300000,99,85,14,false,0,14,174
ReactivePlayer,-98639,15,0.300000,0.300000,0.300000,97,81,16,true,1,16,200
ReactivePlayer,-100929,15,0.300000,0.300000,0.300000,100,92,8,false,0,8,147
ReactivePlayer,-100846,15,0.300000,0.300000,0.300000,100,84,16,false,0,16,183
ReactivePlayer,-1066,15,0.300000,0.300000,0.300000,2,1,1,true,1,1,24
ReactivePlayer,-21190,15,0.300000,0.300000,0.300000,22,17,5,true,1,5,69
ReactivePlayer,-6085,15,0.300000,0.300000,0.300000,7,4,3,true,1,3,50
ReactivePlayer,-3131,15,0.300000,0.300000,0.300000,4,0,4,true,1,4,32
ReactivePlayer,-67036,15,0.300000,0.300000,0.300000,67,55,12,true,1,12,149
ReactivePlayer,-67351,15,0.300000,0.300000,0.300000,67,55,12,true,1,12,157
ReactivePlayer,-59037,15,0.300000,0.300000,0.300000,59,51,8,true,1,8,111
ReactivePlayer,-100629,15,0.300000,0.300000,0.300000,100,89,11,false,0,11,141
ReactivePlayer,-1033,15,0.300000,0.300000,0.300000,2,2,0,true,1,0,17
ReactivePlayer,-26666,15,0.300000,0.300000,0.300000,27,21,6,true,1,6,125
ReactivePlayer,-28359,15,0.300000,0.300000,0.300000,29,25,4,true,1,4,56
ReactivePlayer,-80816,15,0.300000,0.300000,0.300000,81,72,9,true,1,9,137
ReactivePlayer,-15179,15,0.300000,0.300000,0.300000,16,13,3,true,1,3,56
ReactivePlayer,-100269,15,0.300000,0.300000,0.300000,98,84,14,false,0,14,202
ReactivePlayer,-100664,15,0.300000,0.300000,0.300000,100,92,8,false,0,8,71
ReactivePlayer,-100730,15,0.300000,0.300000,0.300000,99,90,9,false,0,9,107
ReactivePlayer,-100422,15,0.300000,0.300000,0.300000,100,93,7,false,0,7,89
ReactivePlayer,-38431,15,0.300000,0.300000,0.300000,39,32,7,true,1,7,95
ReactivePlayer,-100937,15,0.300000,0.300000,0.300000,100,92,8,false,0,8,93
ReactivePlayer,-100097,15,0.300000,0.300000,0.300000,99,82,17,false,0,17,153
ReactivePlayer,-20253,15,0.300000,0.300000,0.300000,21,19,2,true,1,2,114
ReactivePlayer,-22270,15,0.300000,0.300000,0.300000,23,18,5,true,1,5,119
ReactivePlayer,-36536,15,0.300000,0.300000,0.300000,37,26,11,true,1,11,144
ReactivePlayer,-28768,15,0.300000,0.300000,0.300000,29,22,7,true,1,7,114
ReactivePlayer,-52602,15,0.300000,0.300000,0.300000,53,46,7,true,1,7,141
ReactivePlayer,-17191,15,0.300000,0.300000,0.300000,18,17,1,true,1,1,28
ReactivePlayer,-100445,15,0.300000,0.300000,0.300000,99,90,9,false,0,9,95
ReactivePlayer,-74170,15,0.300000,0.300000,0.300000,74,65,9,true,1,9,165
ReactivePlayer,-100912,15,0.300000,0.300000,0.300000,99,85,14,false,0,14,150
ReactivePlayer,-100820,15,0.300000,0.300000,0.300000,100,88,12,false,0,12,142
ReactivePlayer,-86394,15,0.300000,0.300000,0.300000,86,71,15,true,1,15,173
ReactivePlayer,-18215,15,0.300000,0.300000,0.300000,19,13,6,true,1,6,52
ReactivePlayer,-30261,15,0.300000,0.300000,0.300000,31,22,9,true,1,9,97
ReactivePlayer,-100036,15,0.300000,0.300000,0.300000,99,92,7,false,0,7,137
ReactivePlayer,-29413,15,0.300000,0.300000,0.300000,30,27,3,true,1,3,83
ReactivePlayer,-50687,15,0.300000,0.300000,0.300000,51,38,13,true,1,13,145
ReactivePlayer,-24282,15,0.300000,0.300000,0.300000,25,21,4,true,1,4,66
ReactivePlayer,-100315,15,0.300000,0.300000,0.300000,99,89,10,false,0,10,161
ReactivePlayer,-41951,15,0.300000,0.300000,0.300000,42,31,11,true,1,11,103
ReactivePlayer,-39654,15,0.300000,0.300000,0.300000,40,29,11,true,1,11,122
ReactivePlayer,-100317,15,0.300000,0.300000,0.300000,99,91,8,false,0,8,160
ReactivePlayer,1000,15,0.300000,0.300000,0.300000,0,0,0,true,1,0,0
ReactivePlayer,-100479,15,0.300000,0.300000,0.300000,99,92,7,false,0,7,164
ReactivePlayer,-73886,15,0.300000,0.300000,0.300000,74,66,8,true,1,8,118
ReactivePlayer,-64561,15,0.300000,0.300000,0.300000,64,52,12,true,1,12,184
ReactivePlayer,-19314,15,0.300000,0.300000,0.300000,20,16,4,true,1,4,71
ReactivePlayer,-22598,15,0.300000,0.300000,0.300000,23,18,5,true,1,5,114
ReactivePlayer,-24220,15,0.300000,0.300000,0.300000,25,23,2,true,1,2,34
ReactivePlayer,-100874,15,0.300000,0.300000,0.300000,100,89,11,false,0,11,157
ReactivePlayer,-28420,15,0.300000,0.300000,0.300000,29,24,5,true,1,5,71
ReactivePlayer,-100559,15,0.300000,0.300000,0.300000,99,86,13,false,0,13,170
ReactivePlayer,-100173,15,0.300000,0.300000,0.300000,99,82,17,false,0,17,160
ReactivePlayer,-77567,15,0.300000,0.300000,0.300000,78,68,10,true,1,10,136
ReactivePlayer,-1031,15,0.300000,0.300000,0.300000,2,1,1,true,1,1,19
ReactivePlayer,-100767,15,0.300000,0.300000,0.300000,99,82,17,false,0,17,207
ReactivePlayer,-24776,15,0.300000,0.300000,0.300000,25,14,11,true,1,11,123
ReactivePlayer,-100317,15,0.300000,0.300000,0.300000,99,89,10,false,0,10,143
ReactivePlayer,-100992,15,0.300000,0.300000,0.300000,100,91,9,false,0,9,162
ReactivePlayer,-5176,15,0.300000,0.300000,0.300000,6,4,2,true,1,2,49
ReactivePlayer,995,15,0.300000,0.300000,0.300000,0,0,0,true,1,0,3
ReactivePlayer,-100868,15,0.300000,0.300000,0.300000,99,85,14,false,0,14,190
ReactivePlayer,-44560,15,0.300000,0.300000,0.300000,45,28,17,true,1,17,143
ReactivePlayer,-100121,15,0.300000,0.300000,0.300000,99,86,13,false,0,13,152
ReactivePlayer,-100730,15,0.300000,0.300000,0.300000,98,88,10,false,0,10,203
ReactivePlayer,-82782,15,0.300000,0.300000,0.300000,82,73,9,true,1,9,192
ReactivePlayer,-24275,15,0.300000,0.300000,0.300000,25,21,4,true,1,4,43
ReactivePlayer,-71945,15,0.300000,0.300000,0.300000,72,46,26,true,1,26,179
ReactivePlayer,-100059,15,0.300000,0.300000,0.300000,98,79,19,false,0,19,203
ReactivePlayer,-11261,15,0.300000,0.300000,0.300000,12,9,3,true,1,3,70
ReactivePlayer,-21257,15,0.300000,0.300000,0.300000,22,22,0,true,1,0,41
ReactivePlayer,-10153,15,0.300000,0.300000,0.300000,11,8,3,true,1,3,54
ReactivePlayer,-100278,15,0.300000,0.300000,0.300000,99,83,16,false,0,16,184
ReactivePlayer,995,15,0.300000,0.300000,0.300000,0,0,0,true,1,0,5
ReactivePlayer,-5042,15,0.300000,0.300000,0.300000,6,4,2,true,1,2,33
ReactivePlayer,-30499,15,0.300000,0.300000,0.300000,31,28,3,true,1,3,73
ReactivePlayer,-3160,15,0.300000,0.300000,0.300000,4,2,2,true,1,2,57
ReactivePlayer,-87910,15,0.300000,0.300000,0.300000,88,80,8,true,1,8,154
ReactivePlayer,-41393,15,0.300000,0.300000,0.300000,42,38,4,true,1,4,107
ReactivePlayer,-53941,15,0.300000,0.300000,0.300000,54,44,10,true,1,10,149
ReactivePlayer,-38492,15,0.300000,0.300000,0.300000,39,25,14,true,1,14,103
ReactivePlayer,-71148,15,0.300000,0.300000,0.300000,71,55,16,true,1,16,186
ReactivePlayer,-100163,15,0.300000,0.300000,0.300000,99,87,12,false,0,12,132
ReactivePlayer,-100081,15,0.300000,0.300000,0.300000,99,94,5,false,0,5,98
ReactivePlayer,-89961,15,0.300000,0.300000,0.300000,90,75,15,true,1,15,124
ReactivePlayer,-23469,15,0.300000,0.300000,0.300000,24,18,6,true,1,6,64
ReactivePlayer,-50187,15,0.300000,0.300000,0.300000,50,33,17,true,1,17,157
ReactivePlayer,-1085,15,0.300000,0.300000,0.300000,2,1,1,true,1,1,37
ReactivePlayer,-100156,15,0.300000,0.300000,0.300000,99,82,17,false,0,17,190
ReactivePlayer,-52740,15,0.300000,0.300000,0.300000,53,42,11,true,1,11,68
ReactivePlayer,-100809,15,0.300000,0.300000,0.300000,100,97,3,false,0,3,119
ReactivePlayer,-37756,15,0.300000,0.300000,0.300000,38,27,11,true,1,11,134
ReactivePlayer,-36479,15,0.300000,0.300000,0.300000,37,16,21,true,1,21,101
ReactivePlayer,-71037,15,0.300000,0.300000,0.300000,71,60,11,true,1,11,143
ReactivePlayer,-1128,15,0.300000,0.300000,0.300000,2,0,2,true,1,2,44
ReactivePlayer,-4048,15,0.300000,0.300000,0.300000,5,4,1,true,1,1,22
ReactivePlayer,992,15,0.300000,0.300000,0.300000,0,0,0,true,1,0,6
ReactivePlayer,-1026,15,0.300000,0.300000,0.300000,2,1,1,true,1,1,18
ReactivePlayer,-2055,15,0.300000,0.300000,0.300000,3,1,2,true,1,2,28
ReactivePlayer,-78005,15,0.300000,0.300000,0.300000,78,69,9,true,1,9,106
ReactivePlayer,-100297,15,0.300000,0.300000,0.300000,99,90,9,false,0,9,176
ReactivePlayer,-96309,15,0.300000,0.300000,0.300000,96,86,10,true,1,10,181
ReactivePlayer,-64492,15,0.300000,0.300000,0.300000,65,50,15,true,1,15,129
ReactivePlayer,-86770,15,0.300000,0.300000,0.300000,87,72,15,true,1,15,112
ReactivePlayer,-100198,15,0.300000,0.300000,0.300000,99,80,19,false,0,19,187
ReactivePlayer,-37259,15,0.300000,0.300000,0.300000,38,26,12,true,1,12,111
ReactivePlayer,-90768,15,0.300000,0.300000,0.300000,90,75,15,true,1,15,188
ReactivePlayer,-100265,15,0.300000,0.300000,0.300000,98,81,17,false,0,17,191
ReactivePlayer,-51104,15,0.300000,0.300000,0.300000,51,34,17,true,1,17,177
ReactivePlayer,-100305,15,0.300000,0.300000,0.300000,98,89,9,false,0,9,192
ReactivePlayer,-29672,15,0.300000,0.300000,0.300000,30,20,10,true,1,10,118
ReactivePlayer,-100785,15,0.300000,0.300000,0.300000,100,89,11,false,0,11,155
ReactivePlayer,-100905,15,0.300000,0.300000,0.300000,100,93,7,false,0,7,111
ReactivePlayer,-86640,15,0.300000,0.300000,0.300000,87,71,16,true,1,16,147
ReactivePlayer,-52628,15,0.300000,0.300000,0.300000,53,51,2,true,1,2,103
ReactivePlayer,-5060,15,0.300000,0.300000,0.300000,6,3,3,true,1,3,37
ReactivePlayer,-73773,15,0.300000,0.300000,0.300000,74,63,11,true,1,11,158
ReactivePlayer,-68706,15,0.300000,0.300000,0.300000,69,65,4,true,1,4,92
ReactivePlayer,-48545,15,0.300000,0.300000,0.300000,49,35,14,true,1,14,136
ReactivePlayer,-93082,15,0.300000,0.300000,0.300000,93,80,13,true,1,13,176
ReactivePlayer,-100218,15,0.300000,0.300000,0.300000,99,88,11,false,0,11,105
ReactivePlayer,-100271,15,0.300000,0.300000,0.300000,98,89,9,false,0,9,205
ReactivePlayer,-5297,15,0.300000,0.300000,0.300000,6,1,5,true,1,5,51
ReactivePlayer,-100325,15,0.300000,0.300000,0.300000,99,92,7,false,0,7,100
ReactivePlayer,-8350,15,0.300000,0.300000,0.300000,9,5,4,true,1,4,61
ReactivePlayer,-100928,15,0.300000,0.300000,0.300000,100,89,11,false,0,11,131
ReactivePlayer,-17566,15,0.300000,0.300000,0.300000,18,8,10,true,1,10,88
ReactivePlayer,-100528,15,0.300000,0.300000,0.300000,99,90,9,false,0,9,179
ReactivePlayer,-100272,15,0.300000,0.300000,0.300000,99,81,18,false,0,18,204
ReactivePlayer,-97694,15,0.300000,0.300000,0.300000,97,84,13,true,1,13,137
ReactivePlayer,-23231,15,0.300000,0.300000,0.300000,24,15,9,true,1,9,68
ReactivePlayer,-100931,15,0.300000,0.300000,0.300000,99,85,14,false,0,14,161
ReactivePlayer,-100889,15,0.300000,0.300000,0.300000,100,91,9,false,0,9,128
ReactivePlayer,-100135,15,0.300000,0.300000,0.300000,99,88,11,false,0,11,167
ReactivePlayer,-50580,15,0.300000,0.300000,0.300000,51,47,4,true,1,4,118
ReactivePlayer,-19,15,0.300000,0.300000,0.300000,1,0,1,true,1,1,9
ReactivePlayer,-35760,15,0.300000,0.300000,0.300000,36,32,4,true,1,4,119
ReactivePlayer,-100229,15,0.300000,0.300000,0.300000,99,86,13,false,0,13,171
ReactivePlayer,-9,15,0.300000,0.300000,0.300000,1,0,1,true,1,1,5
ReactivePlayer,-100008,15,0.300000,0.300000,0.300000,99,82,17,false,0,17,155
ReactivePlayer,-79860,15,0.300000,0.300000,0.300000,80,67,13,true,1,13,144
ReactivePlayer,-21352,15,0.300000,0.300000,0.300000,22,17,5,true,1,5,105
ReactivePlayer,-100227,15,0.300000,0.300000,0.300000,99,84,15,false,0,15,192
ReactivePlayer,-100013,15,0.300000,0.300000,0.300000,99,89,10,false,0,10,146
ReactivePlayer,-50,15,0.300000,0.300000,0.300000,1,0,1,true,1,1,26
ReactivePlayer,-45594,15,0.300000,0.300000,0.300000,46,28,18,true,1,18,141
ReactivePlayer,-18,15,0.300000,0.300000,0.300000,1,1,0,true,1,0,7
ReactivePlayer,-6,15,0.300000,0.300000,0.300000,1,0,1,true,1,1,3
ReactivePlayer,-97193,15,0.300000,0.300000,0.300000,97,87,10,true,1,10,147
ReactivePlayer,-83944,15,0.300000,0.300000,0.300000,84,64,20,true,1,20,172
ReactivePlayer,995,15,0.300000,0.300000,0.300000,0,0,0,true,1,0,2
ReactivePlayer,-100119,15,0.300000,0.300000,0.300000,99,84,15,false,0,15,183
ReactivePlayer,-100355,15,0.300000,0.300000,0.300000,99,85,14,false,0,14,207
ReactivePlayer,-100401,15,0.300000,0.300000,0.300000,99,96,3,false,0,3,127
ReactivePlayer,-100000,15,0.300000,0.300000,0.300000,98,86,12,false,0,12,201
ReactivePlayer,-100461,15,0.300000,0.300000,0.300000,98,81,17,false,0,17,193
ReactivePlayer,-73539,15,0.300000,0.300000,0.300000,74,64,10,true,1,10,148
ReactivePlayer,-100857,15,0.300000,0.300000,0.300000,100,96,4,false,0,4,123
ReactivePlayer,-35530,15,0.300000,0.300000,0.300000,36,29,7,true,1,7,119
ReactivePlayer,-11268,15,0.300000,0.300000,0.300000,12,10,2,true,1,2,62
ReactivePlayer,-48888,15,0.300000,0.300000,0.300000,49,42,7,true,1,7,138
ReactivePlayer,-51539,15,0.300000,0.300000,0.300000,52,41,11,true,1,11,113
ReactivePlayer,-79885,15,0.300000,0.300000,0.300000,80,63,17,true,1,17,171
ReactivePlayer,-1024,15,0.300000,0.300000,0.300000,2,0,2,true,1,2,15
ReactivePlayer,-41639,15,0.300000,0.300000,0.300000,42,32,10,true,1,10,84
ReactivePlayer,-27499,15,0.300000,0.300000,0.300000,28,24,4,true,1,4,79
ReactivePlayer,-100669,15,0.300000,0.300000,0.300000,100,98,2,false,0,2,36
ReactivePlayer,-1056,15,0.300000,0.300000,0.300000,2,1,1,true,1,1,34
ReactivePlayer,-100398,15,0.300000,0.300000,0.300000,99,86,13,false,0,13,170
ReactivePlayer,-65927,15,0.300000,0.300000,0.300000,66,51,15,true,1,15,119
ReactivePlayer,-100624,15,0.300000,0.300000,0.300000,100,95,5,false,0,5,58
ReactivePlayer,-3017,15,0.300000,0.300000,0.300000,4,4,0,true,1,0,6
ReactivePlayer,-100184,15,0.300000,0.300000,0.300000,99,79,20,false,0,20,153
ReactivePlayer,-100508,15,0.300000,0.300000,0.300000,98,84,14,false,0,14,182
ReactivePlayer,-100757,15,0.300000,0.300000,0.300000,99,87,12,false,0,12,145
ReactivePlayer,-100430,15,0.300000,0.300000,0.300000,99,90,9,false,0,9,191
ReactivePlayer,-1011,15,0.300000,0.300000,0.300000,2,0,2,true,1,2,11
ReactivePlayer,-6080,15,0.300000,0.300000,0.300000,7,4,3,true,1,3,39
ReactivePlayer,-100785,15,0.300000,0.300000,0.300000,100,92,8,false,0,8,141
ReactivePlayer,-28412,15,0.300000,0.300000,0.300000,29,18,11,true,1,11,95
ReactivePlayer,-30741,15,0.300000,0.300000,0.300000,31,24,7,true,1,7,87
ReactivePlayer,-51730,15,0.300000,0.300000,0.300000,52,40,12,true,1,12,124
ReactivePlayer,-15479,15,0.300000,0.300000,0.300000,16,14,2,true,1,2,30
ReactivePlayer,-100125,15,0.300000,0.300000,0.300000,99,89,10,false,0,10,187
ReactivePlayer,-100116,15,0.300000,0.300000,0.300000,99,91,8,false,0,8,118
ReactivePlayer,-93775,15,0.300000,0.300000,0.300000,94,86,8,true,1,8,125
ReactivePlayer,-100224,15,0.300000,0.300000,0.300000,97,78,19,false,0,19,225
ReactivePlayer,-68958,15,0.300000,0.300000,0.300000,69,56,13,true,1,13,200
ReactivePlayer,-54888,15,0.300000,0.300000,0.300000,55,45,10,true,1,10,159
ReactivePlayer,-100551,15,0.300000,0.300000,0.300000,99,89,10,false,0,10,197
ReactivePlayer,-71684,15,0.300000,0.300000,0.300000,72,64,8,true,1,8,127
ReactivePlayer,-100110,15,0.300000,0.300000,0.300000,99,87,12,false,0,12,136
ReactivePlayer,-11093,15,0.300000,0.300000,0.300000,12,10,2,true,1,2,53
ReactivePlayer,-41439,15,0.300000,0.300000,0.300000,42,35,7,true,1,7,133
ReactivePlayer,-33802,15,0.300000,0.300000,0.300000,34,24,10,true,1,10,106
ReactivePlayer,-100606,15,0.300000,0.300000,0.300000,99,86,13,false,0,13,177
ReactivePlayer,-100286,15,0.300000,0.300000,0.300000,98,75,23,false,0,23,204
ReactivePlayer,-84966,15,0.300000,0.300000,0.300000,85,76,9,true,1,9,143
ReactivePlayer,-9078,15,0.300000,0.300000,0.300000,10,6,4,true,1,4,43
ReactivePlayer,-55117,15,0.300000,0.300000,0.300000,55,37,18,true,1,18,173
ReactivePlayer,-34879,15,0.300000,0.300000,0.300000,35,29,6,true,1,6,86
ReactivePlayer,-35653,15,0.300000,0.300000,0.300000,36,26,10,true,1,10,138
ReactivePlayer,-100588,15,0.300000,0.300000,0.300000,99,87,12,false,0,12,203
ReactivePlayer,-52900,15,0.300000,0.300000,0.300000,53,48,5,true,1,5,120
ReactivePlayer,-100188,15,0.300000,0.300000,0.300000,99,90,9,false,0,9,159
ReactivePlayer,-55304,15,0.300000,0.300000,0.300000,56,47,9,true,1,9,89
ReactivePlayer,996,15,0.300000,0.300000,0.300000,0,0,0,true,1,0,4
ReactivePlayer,-1023,15,0.300000,0.300000,0.300000,2,2,0,true,1,0,11
ReactivePlayer,-2067,15,0.300000,0.300000,0.300000,3,2,1,true,1,1,22
ReactivePlayer,-56821,15,0.300000,0.300000,0.300000,57,49,8,true,1,8,145
ReactivePlayer,-22338,15,0.300000,0.300000,0.300000,23,16,7,true,1,7,91
ReactivePlayer,-23204,15,0.300000,0.300000,0.300000,24,14,10,true,1,10,77
ReactivePlayer,-10295,15,0.300000,0.300000,0.300000,11,7,4,true,1,4,88
ReactivePlayer,-4025,15,0.300000,0.300000,0.300000,5,4,1,true,1,1,10
ReactivePlayer,-10116,15,0.300000,0.300000,0.300000,11,6,5,true,1,5,39
ReactivePlayer,-81959,15,0.300000,0.300000,0.300000,82,73,9,true,1,9,152
ReactivePlayer,-51553,15,0.300000,0.300000,0.300000,52,41,11,true,1,11,113
ReactivePlayer,-100869,15,0.300000,0.300000,0.300000,100,100,0,false,0,0,38
ReactivePlayer,-100679,15,0.300000,0.300000,0.300000,100,89,11,false,0,11,134
ReactivePlayer,-96429,15,0.300000,0.300000,0.300000,96,76,20,true,1,20,180
ReactivePlayer,-100889,15,0.300000,0.300000,0.300000,100,90,10,false,0,10,150
ReactivePlayer,-29488,15,0.300000,0.300000,0.300000,30,23,7,true,1,7,106
ReactivePlayer,-100050,15,0.300000,0.300000,0.300000,98,81,17,false,0,17,205
ReactivePlayer,-100453,15,0.300000,0.300000,0.300000,99,90,9,false,0,9,143
ReactivePlayer,-66914,15,0.300000,0.300000,0.300000,67,57,10,true,1,10,134
ReactivePlayer,-6046,15,0.300000,0.300000,0.300000,7,6,1,true,1,1,25
ReactivePlayer,-71925,15,0.300000,0.300000,0.300000,72,60,12,true,1,12,136
ReactivePlayer,-58031,15,0.300000,0.300000,0.300000,58,40,18,true,1,18,163
ReactivePlayer,-100823,15,0.300000,0.300000,0.300000,100,93,7,false,0,7,148
ReactivePlayer,-36378,15,0.300000,0.300000,0.300000,37,30,7,true,1,7,67
ReactivePlayer,-27699,15,0.300000,0.300000,0.300000,28,19,9,true,1,9,129
ReactivePlayer,-100404,15,0.300000,0.300000,0.300000,98,79,19,false,0,19,211
ReactivePlayer,-60645,15,0.300000,0.300000,0.300000,61,56,5,true,1,5,112
ReactivePlayer,-55754,15,0.300000,0.300000,0.300000,56,43,13,true,1,13,138
ReactivePlayer,-100928,15,0.300000,0.300000,0.300000,100,90,10,false,0,10,78
ReactivePlayer,-2040,15,0.300000,0.300000,0.300000,3,3,0,true,1,0,14
ReactivePlayer,-100316,15,0.300000,0.300000,0.300000,99,80,19,false,0,19,177
ReactivePlayer,-67723,15,0.300000,0.300000,0.300000,68,53,15,true,1,15,167
ReactivePlayer,-63469,15,0.300000,0.300000,0.300000,64,55,9,true,1,9,95
ReactivePlayer,-8201,15,0.300000,0.300000,0.300000,9,7,2,true,1,2,63
ReactivePlayer,-44032,15,0.300000,0.300000,0.300000,44,37,7,true,1,7,115
ReactivePlayer,-74197,15,0.300000,0.300000,0.300000,74,63,11,true,1,11,162
ReactivePlayer,-52484,15,0.300000,0.300000,0.300000,53,46,7,true,1,7,91
ReactivePlayer,-87165,15,0.300000,0.300000,0.300000,87,73,14,true,1,14,150
ReactivePlayer,-100244,15,0.300000,0.300000,0.300000,99,82,17,false,0,17,162
ReactivePlayer,-67177,15,0.300000,0.300000,0.300000,67,50,17,true,1,17,190
ReactivePlayer,-44585,15,0.300000,0.300000,0.300000,45,34,11,true,1,11,129
ReactivePlayer,-83980,15,0.300000,0.300000,0.300000,83,70,13,true,1,13,154
ReactivePlayer,-100231,15,0.300000,0.300000,0.300000,98,89,9,false,0,9,166
ReactivePlayer,-100015,15,0.300000,0.300000,0.300000,99,85,14,false,0,14,176
ReactivePlayer,971,15,0.300000,0.300000,0.300000,0,0,0,true,1,0,4
ReactivePlayer,-95872,15,0.300000,0.300000,0.300000,96,82,14,true,1,14,128
ReactivePlayer,-21375,15,0.300000,0.300000,0.300000,22,14,8,true,1,8,102
ReactivePlayer,-44316,15,0.300000,0.300000,0.300000,45,29,16,true,1,16,97
ReactivePlayer,-38385,15,0.300000,0.300000,0.300000,39,32,7,true,1,7,96
ReactivePlayer,-47985,15,0.300000,0.300000,0.300000,48,31,17,true,1,17,184
ReactivePlayer,-100177,15,0.300000,0.300000,0.300000,99,86,13,false,0,13,157
ReactivePlayer,-62756,15,0.300000,0.300000,0.300000,63,52,11,true,1,11,149
ReactivePlayer,-4076,15,0.300000,0.300000,0.300000,5,4,1,true,1,1,29
ReactivePlayer,-54915,15,0.300000,0.300000,0.300000,55,38,17,true,1,17,126
ReactivePlayer,-100734,15,0.300000,0.300000,0.300000,99,84,15,false,0,15,194
ReactivePlayer,-46534,15,0.300000,0.300000,0.300000,47,41,6,true,1,6,107
ReactivePlayer,-1012,15,0.300000,0.300000,0.300000,2,0,2,true,1,2,6
ReactivePlayer,-100149,15,0.300000,0.300000,0.300000,99,80,19,false,0,19,175
ReactivePlayer,-70135,15,0.300000,0.300000,0.300000,70,48,22,true,1,22,178
ReactivePlayer,-6286,15,0.300000,0.300000,0.300000,7,3,4,true,1,4,70
ReactivePlayer,-100848,15,0.300000,0.300000,0.300000,100,85,15,false,0,15,175
ReactivePlayer,-80132,15,0.300000,0.300000,0.300000,80,68,12,true,1,12,152
ReactivePlayer,-30502,15,0.300000,0.300000,0.300000,31,25,6,true,1,6,93
ReactivePlayer,-4047,15,0.300000,0.300000,0.300000,5,2,3,true,1,3,15
ReactivePlayer,-34516,15,0.300000,0.300000,0.300000,35,29,6,true,1,6,114
ReactivePlayer,-100729,15,0.300000,0.300000,0.300000,99,88,11,false,0,11,196
ReactivePlayer,-76321,15,0.300000,0.300000,0.300000,76,59,17,true,1,17,181
ReactivePlayer,-33192,15,0.300000,0.300000,0.300000,34,26,8,true,1,8,70
ReactivePlayer,-2090,15,0.300000,0.300000,0.300000,3,2,1,true,1,1,36
ReactivePlayer,-63640,15,0.300000,0.300000,0.300000,64,53,11,true,1,11,119
ReactivePlayer,-80812,15,0.300000,0.300000,0.300000,81,75,6,true,1,6,143
ReactivePlayer,-8,15,0.300000,0.300000,0.300000,1,0,1,true,1,1,5
ReactivePlayer,-25361,15,0.300000,0.300000,0.300000,26,22,4,true,1,4,89
ReactivePlayer,-87074,15,0.300000,0.300000,0.300000,86,71,15,true,1,15,180
ReactivePlayer,-71744,15,0.300000,0.300000,0.300000,72,66,6,true,1,6,165
ReactivePlayer,-11248,15,0.300000,0.300000,0.300000,12,5,7,true,1,7,71
ReactivePlayer,-3032,15,0.300000,0.300000,0.300000,4,4,0,true,1,0,14
ReactivePlayer,-39642,15,0.300000,0.300000,0.300000,40,27,13,true,1,13,131
ReactivePlayer,-94103,15,0.300000,0.300000,0.300000,94,83,11,true,1,11,134
ReactivePlayer,-6117,15,0.300000,0.300000,0.300000,7,3,4,true,1,4,26
ReactivePlayer,-100910,15,0.300000,0.300000,0.300000,99,92,7,false,0,7,174
ReactivePlayer,-64405,15,0.300000,0.300000,0.300000,64,57,7,true,1,7,159
ReactivePlayer,-4039,15,0.300000,0.300000,0.300000,5,5,0,true,1,0,16
ReactivePlayer,-100907,15,0.300000,0.300000,0.300000,100,89,11,false,0,11,163
ReactivePlayer,-74024,15,0.300000,0.300000,0.300000,74,67,7,true,1,7,89
ReactivePlayer,-85406,15,0.300000,0.300000,0.300000,85,69,16,true,1,16,206
ReactivePlayer,-28198,15,0.300000,0.300000,0.300000,29,21,8,true,1,8,54
ReactivePlayer,961,15,0.300000,0.300000,0.300000,0,0,0,true,1,0,16
ReactivePlayer,-100512,15,0.300000,0.300000,0.300000,99,84,15,false,0,15,217
ReactivePlayer,-20249,15,0.300000,0.300000,0.300000,21,17,4,true,1,4,55
ReactivePlayer,-7148,15,0.300000,0.300000,0.300000,8,5,3,true,1,3,60
ReactivePlayer,-18155,15,0.300000,0.300000,0.300000,19,14,5,true,1,5,62
ReactivePlayer,-93889,15,0.300000,0.300000,0.300000,94,78,16,true,1,16,168
ReactivePlayer,-30449,15,0.300000,0.300000,0.300000,31,23,8,true,1,8,92
ReactivePlayer,-100359,15,0.300000,0.300000,0.300000,99,89,10,false,0,10,175
ReactivePlayer,-76941,15,0.300000,0.300000,0.300000,77,66,11,true,1,11,180
ReactivePlayer,-28414,15,0.300000,0.300000,0.300000,29,20,9,true,1,9,89
ReactivePlayer,-43314,15,0.300000,0.300000,0.300000,44,42,2,true,1,2,118
ReactivePlayer,-90254,15,0.300000,0.300000,0.300000,90,75,15,true,1,15,186
ReactivePlayer,-100124,15,0.300000,0.300000,0.300000,99,95,4,false,0,4,150
ReactivePlayer,-100959,15,0.300000,0.300000,0.300000,100,92,8,false,0,8,112
ReactivePlayer,-100645,15,0.300000,0.300000,0.300000,100,90,10,false,0,10,60
ReactivePlayer,-100073,15,0.300000,0.300000,0.300000,99,92,7,false,0,7,151
ReactivePlayer,-51329,15,0.300000,0.300000,0.300000,51,45,6,true,1,6,146
ReactivePlayer,-100174,15,0.300000,0.300000,0.300000,99,92,7,false,0,7,144
ReactivePlayer,-30447,15,0.300000,0.300000,0.300000,31,25,6,true,1,6,110
ReactivePlayer,-9051,15,0.300000,0.300000,0.300000,10,8,2,true,1,2,21
ReactivePlayer,937,15,0.300000,0.300000,0.300000,0,0,0,true,1,0,12
ReactivePlayer,-100980,15,0.300000,0.300000,0.300000,100,77,23,false,0,23,189
ReactivePlayer,-100152,15,0.300000,0.300000,0.300000,99,89,10,false,0,10,157
ReactivePlayer,-2110,15,0.300000,0.300000,0.300000,3,1,2,true,1,2,31
ReactivePlayer,980,15,0.300000,0.300000,0.300000,0,0,0,true,1,0,14
ReactivePlayer,-100072,15,0.300000,0.300000,0.300000,99,89,10,false,0,10,146
ReactivePlayer,-4113,15,0.300000,0.300000,0.300000,5,3,2,true,1,2,25
ReactivePlayer,-100463,15,0.300000,0.300000,0.300000,99,86,13,false,0,13,156
ReactivePlayer,-12226,15,0.300000,0.300000,0.300000,13,9,4,true,1,4,84
ReactivePlayer,-55840,15,0.300000,0.300000,0.300000,56,45,11,true,1,11,148
ReactivePlayer,-65590,15,0.300000,0.300000,0.300000,66,52,14,true,1,14,147
ReactivePlayer,-54680,15,0.300000,0.300000,0.300000,55,49,6,true,1,6,125
ReactivePlayer,-100349,15,0.300000,0.300000,0.300000,99,88,11,false,0,11,211
ReactivePlayer,-93420,15,0.300000,0.300000,0.300000,93,78,15,true,1,15,184
ReactivePlayer,-100813,15,0.300000,0.300000,0.300000,100,83,17,false,0,17,140
ReactivePlayer,-59507,15,0.300000,0.300000,0.300000,60,53,7,true,1,7,82
ReactivePlayer,994,15,0.300000,0.300000,0.300000,0,0,0,true,1,0,2
ReactivePlayer,-100601,15,0.300000,0.300000,0.300000,99,86,13,false,0,13,163
ReactivePlayer,-100562,15,0.300000,0.300000,0.300000,99,84,15,false,0,15,189
ReactivePlayer,997,15,0.300000,0.300000,0.300000,0,0,0,true,1,0,3
ReactivePlayer,-22197,15,0.300000,0.300000,0.300000,23,15,8,true,1,8,66
ReactivePlayer,-9102,15,0.300000,0.300000,0.300000,10,9,1,true,1,1,56
ReactivePlayer,-9155,15,0.300000,0.300000,0.300000,10,9,1,true,1,1,54
ReactivePlayer,-39255,15,0.300000,0.300000,0.300000,39,26,13,true,1,13,138
ReactivePlayer,-8208,15,0.300000,0.300000,0.300000,9,5,4,true,1,4,62
ReactivePlayer,-29694,15,0.300000,0.300000,0.300000,30,24,6,true,1,6,142
ReactivePlayer,-47854,15,0.300000,0.300000,0.300000,48,40,8,true,1,8,160
ReactivePlayer,-68251,15,0.300000,0.300000,0.300000,68,63,5,true,1,5,120
ReactivePlayer,-17159,15,0.300000,0.300000,0.300000,18,12,6,true,1,6,60
ReactivePlayer,-100064,15,0.300000,0.300000,0.300000,99,84,15,false,0,15,175
ReactivePlayer,-31255,15,0.300000,0.300000,0.300000,32,28,4,true,1,4,57
ReactivePlayer,1000,15,0.300000,0.300000,0.300000,0,0,0,true,1,0,0
ReactivePlayer,-46621,15,0.300000,0.300000,0.300000,47,34,13,true,1,13,141
ReactivePlayer,-100191,15,0.300000,0.300000,0.300000,99,90,9,false,0,9,177
ReactivePlayer,-91198,15,0.300000,0.300000,0.300000,91,74,17,true,1,17,164
ReactivePlayer,-100639,15,0.300000,0.300000,0.300000,100,94,6,false,0,6,126
ReactivePlayer,999,15,0.300000,0.300000,0.300000,0,0,0,true,1,0,1
ReactivePlayer,-100000,15,0.300000,0.300000,0.300000,98,80,18,false,0,18,205
ReactivePlayer,-2,15,0.300000,0.300000,0.300000,1,0,1,true,1,1,2
ReactivePlayer,-16179,15,0.300000,0.300000,0.300000,17,13,4,true,1,4,60
ReactivePlayer,-56788,15,0.300000,0.300000,0.300000,57,46,11,true,1,11,135
ReactivePlayer,-10088,15,0.300000,0.300000,0.300000,11,11,0,true,1,0,44
ReactivePlayer,-100236,15,0.300000,0.300000,0.300000,98,80,18,false,0,18,203
ReactivePlayer,-52802,15,0.300000,0.300000,0.300000,53,47,6,true,1,6,88
ReactivePlayer,-100989,15,0.300000,0.300000,0.300000,99,81,18,false,0,18,173
ReactivePlayer,-100843,15,0.300000,0.300000,0.300000,99,86,13,false,0,13,184
ReactivePlayer,-100765,15,0.300000,0.300000,0.300000,99,86,13,false,0,13,165
ReactivePlayer,-100826,15,0.300000,0.300000,0.300000,100,90,10,false,0,10,134
ReactivePlayer,-35535,15,0.300000,0.300000,0.300000,36,22,14,true,1,14,133
ReactivePlayer,-27554,15,0.300000,0.300000,0.300000,28,14,14,true,1,14,156
ReactivePlayer,-5064,15,0.300000,0.300000,0.300000,6,4,2,true,1,2,29
ReactivePlayer,-22254,15,0.300000,0.300000,0.300000,23,17,6,true,1,6,80
ReactivePlayer,-3028,15,0.300000,0.300000,0.300000,4,4,0,true,1,0,23
ReactivePlayer,-100034,15,0.300000,0.300000,0.300000,99,86,13,false,0,13,168
ReactivePlayer,-100662,15,0.300000,0.300000,0.300000,100,89,11,false,0,11,134
ReactivePlayer,-100505,15,0.300000,0.300000,0.300000,99,94,5,false,0,5,204
ReactivePlayer,-35331,15,0.300000,0.300000,0.300000,36,27,9,true,1,9,76
ReactivePlayer,-100963,15,0.300000,0.300000,0.300000,99,84,15,false,0,15,185
ReactivePlayer,-8141,15,0.300000,0.300000,0.300000,9,2,7,true,1,7,43
ReactivePlayer,-100980,15,0.300000,0.300000,0.300000,100,94,6,false,0,6,113
ReactivePlayer,-100505,15,0.300000,0.300000,0.300000,99,88,11,false,0,11,183
ReactivePlayer,-32336,15,0.300000,0.300000,0.300000,33,27,6,true,1,6,126
ReactivePlayer,-100443,15,0.300000,0.300000,0.300000,99,85,14,false,0,14,163
ReactivePlayer,-64617,15,0.300000,0.300000,0.300000,65,55,10,true,1,10,140
ReactivePlayer,-71200,15,0.300000,0.300000,0.300000,71,64,7,true,1,7,113
ReactivePlayer,-98817,15,0.300000,0.300000,0.300000,99,87,12,true,1,12,155
ReactivePlayer,-100049,15,0.300000,0.300000,0.300000,99,87,12,false,0,12,184
ReactivePlayer,-12256,15,0.300000,0.300000,0.300000,13,7,6,true,1,6,91
ReactivePlayer,-32552,15,0.300000,0.300000,0.300000,33,27,6,true,1,6,86
ReactivePlayer,-100477,15,0.300000,0.300000,0.300000,99,88,11,false,0,11,178
ReactivePlayer,-51672,15,0.300000,0.300000,0.300000,52,41,11,true,1,11,109
ReactivePlayer,-4021,15,0.300000,0.300000,0.300000,5,4,1,true,1,1,13
ReactivePlayer,-81340,15,0.300000,0.300000,0.300000,80,76,4,true,1,4,204
ReactivePlayer,-93168,15,0.300000,0.300000,0.300000,93,84,9,true,1,9,194
ReactivePlayer,-10047,15,0.300000,0.300000,0.300000,11,8,3,true,1,3,24
ReactivePlayer,-6170,15,0.300000,0.300000,0.300000,7,4,3,true,1,3,65
ReactivePlayer,-100269,15,0.300000,0.300000,0.300000,99,82,17,false,0,17,207
ReactivePlayer,-100359,15,0.300000,0.300000,0.300000,99,85,14,false,0,14,196
ReactivePlayer,-100812,15,0.300000,0.300000,0.300000,100,84,16,false,0,16,147
ReactivePlayer,-100528,15,0.300000,0.300000,0.300000,99,90,9,false,0,9,168
ReactivePlayer,-100247,15,0.300000,0.300000,0.300000,99,86,13,false,0,13,174
ReactivePlayer,-60080,15,0.300000,0.300000,0.300000,60,47,13,true,1,13,143
ReactivePlayer,-41641,15,0.300000,0.300000,0.300000,42,34,8,true,1,8,126
ReactivePlayer,-71342,15,0.300000,0.300000,0.300000,71,51,20,true,1,20,177
ReactivePlayer,-42259,15,0.300000,0.300000,0.300000,43,31,12,true,1,12,80
ReactivePlayer,-100883,15,0.300000,0.300000,0.300000,100,90,10,false,0,10,143
ReactivePlayer,-100403,15,0.300000,0.300000,0.300000,99,86,13,false,0,13,151
ReactivePlayer,-39858,15,0.300000,0.300000,0.300000,40,26,14,true,1,14,143
ReactivePlayer,-70365,15,0.300000,0.300000,0.300000,70,63,7,true,1,7,189
ReactivePlayer,-21223,15,0.300000,0.300000,0.300000,22,15,7,true,1,7,73
ReactivePlayer,-1043,15,0.300000,0.300000,0.300000,2,0,2,true,1,2,8
ReactivePlayer,-30347,15,0.300000,0.300000,0.300000,31,26,5,true,1,5,86
ReactivePlayer,-48778,15,0.300000,0.300000,0.300000,49,37,12,true,1,12,143
ReactivePlayer,-37662,15,0.300000,0.300000,0.300000,38,32,6,true,1,6,92
ReactivePlayer,-60612,15,0.300000,0.300000,0.300000,60,42,18,true,1,18,193
ReactivePlayer,-100061,15,0.300000,0.300000,0.300000,99,89,10,false,0,10,174
ReactivePlayer,-100104,15,0.300000,0.300000,0.300000,99,90,9,false,0,9,153
ReactivePlayer,-3098,15,0.300000,0.300000,0.300000,4,0,4,true,1,4,44
ReactivePlayer,-100980,15,0.300000,0.300000,0.300000,100,94,6,false,0,6,91
ReactivePlayer,-23229,15,0.300000,0.300000,0.300000,24,20,4,true,1,4,68
ReactivePlayer,-46772,15,0.300000,0.300000,0.300000,47,32,15,true,1,15,171
ReactivePlayer,-100115,15,0.300000,0.300000,0.300000,99,86,13,false,0,13,154
ReactivePlayer,-100057,15,0.300000,0.300000,0.300000,99,86,13,false,0,13,154
ReactivePlayer,-56105,15,0.300000,0.300000,0.300000,56,49,7,true,1,7,125
ReactivePlayer,-12151,15,0.300000,0.300000,0.300000,13,11,2,true,1,2,29
ReactivePlayer,-23355,15,0.300000,0.300000,0.300000,24,18,6,true,1,6,83
ReactivePlayer,-1040,15,0.300000,0.300000,0.300000,2,1,1,true,1,1,28
ReactivePlayer,-76948,15,0.300000,0.300000,0.300000,77,68,9,true,1,9,162
ReactivePlayer,-100109,15,0.300000,0.300000,0.300000,99,84,15,false,0,15,159
ReactivePlayer,-48878,15,0.300000,0.300000,0.300000,49,42,7,true,1,7,121
ReactivePlayer,-100228,15,0.300000,0.300000,0.300000,99,90,9,false,0,9,165
ReactivePlayer,-100040,15,0.300000,0.300000,0.300000,99,87,12,false,0,12,156
ReactivePlayer,-97897,15,0.300000,0.300000,0.300000,98,93,5,true,1,5,143
ReactivePlayer,-19361,15,0.300000,0.300000,0.300000,20,15,5,true,1,5,74
ReactivePlayer,-100213,15,0.300000,0.300000,0.300000,99,84,15,false,0,15,150
ReactivePlayer,-39753,15,0.300000,0.300000,0.300000,40,28,12,true,1,12,121
ReactivePlayer,-87916,15,0.300000,0.300000,0.300000,88,77,11,true,1,11,174
ReactivePlayer,-66163,15,0.300000,0.300000,0.300000,66,52,14,true,1,14,209
ReactivePlayer,-7092,15,0.300000,0.300000,0.300000,8,7,1,true,1,1,44
ReactivePlayer,-100425,15,0.300000,0.300000,0.300000,99,85,14,false,0,14,166
ReactivePlayer,-82194,15,0.300000,0.300000,0.300000,82,75,7,true,1,7,144
ReactivePlayer,-61948,15,0.300000,0.300000,0.300000,62,49,13,true,1,13,172
ReactivePlayer,-100266,15,0.300000,0.300000,0.300000,99,84,15,false,0,15,134
ReactivePlayer,1000,15,0.300000,0.300000,0.300000,0,0,0,true,1,0,0
ReactivePlayer,-100685,15,0.300000,0.300000,0.300000,100,94,6,false,0,6,110
ReactivePlayer,-23251,15,0.300000,0.300000,0.300000,24,17,7,true,1,7,67
ReactivePlayer,-100939,15,0.300000,0.300000,0.300000,99,89,10,false,0,10,170
ReactivePlayer,-69869,15,0.300000,0.300000,0.300000,70,58,12,true,1,12,134
ReactivePlayer,-30345,15,0.300000,0.300000,0.300000,31,20,11,true,1,11,124
ReactivePlayer,-54683,15,0.300000,0.300000,0.300000,55,45,10,true,1,10,128
ReactivePlayer,-72984,15,0.300000,0.300000,0.300000,73,56,17,true,1,17,160
ReactivePlayer,-3022,15,0.300000,0.300000,0.300000,4,4,0,true,1,0,4
ReactivePlayer,-100965,15,0.300000,0.300000,0.300000,100,92,8,false,0,8,119
ReactivePlayer,-30355,15,0.300000,0.300000,0.300000,31,25,6,true,1,6,105
ReactivePlayer,-98590,15,0.300000,0.300000,0.300000,98,86,12,true,1,12,194
ReactivePlayer,-22162,15,0.300000,0.300000,0.300000,23,20,3,true,1,3,47
ReactivePlayer,-100564,15,0.300000,0.300000,0.300000,99,82,17,false,0,17,165
ReactivePlayer,-29895,15,0.300000,0.300000,0.300000,30,24,6,true,1,6,140
ReactivePlayer,-100297,15,0.300000,0.300000,0.300000,99,85,14,false,0,14,161
ReactivePlayer,-35483,15,0.300000,0.300000,0.300000,36,31,5,true,1,5,64
ReactivePlayer,-100977,15,0.300000,0.300000,0.300000,100,91,9,false,0,9,145
ReactivePlayer,-100858,15,0.300000,0.300000,0.300000,99,89,10,false,0,10,182
ReactivePlayer,-9176,15,0.300000,0.300000,0.300000,10,7,3,true,1,3,41
ReactivePlayer,-100436,15,0.300000,0.300000,0.300000,99,84,15,false,0,15,193
ReactivePlayer,-100849,15,0.300000,0.300000,0.300000,100,90,10,false,0,10,147
ReactivePlayer,-23230,15,0.300000,0.300000,0.300000,24,16,8,true,1,8,57
ReactivePlayer,-16238,15,0.300000,0.300000,0.300000,17,14,3,true,1,3,63
ReactivePlayer,-75162,15,0.300000,0.300000,0.300000,75,61,14,true,1,14,178
ReactivePlayer,-100996,15,0.300000,0.300000,0.300000,100,86,14,false,0,14,69
ReactivePlayer,-96264,15,0.300000,0.300000,0.300000,96,84,12,true,1,12,179
ReactivePlayer,-1059,15,0.300000,0.300000,0.300000,2,2,0,true,1,0,24
ReactivePlayer,-100811,15,0.300000,0.300000,0.300000,100,92,8,false,0,8,144
ReactivePlayer,-12119,15,0.300000,0.300000,0.300000,13,7,6,true,1,6,23
ReactivePlayer,-33080,15,0.300000,0.300000,0.300000,33,18,15,true,1,15,128
ReactivePlayer,-18202,15,0.300000,0.300000,0.300000,19,17,2,true,1,2,27
ReactivePlayer,-64028,15,0.300000,0.300000,0.300000,64,51,13,true,1,13,173
ReactivePlayer,-100834,15,0.300000,0.300000,0.300000,99,85,14,false,0,14,182
ReactivePlayer,-91129,15,0.300000,0.300000,0.300000,91,80,11,true,1,11,164
ReactivePlayer,-3017,15,0.300000,0.300000,0.300000,4,1,3,true,1,3,14
ReactivePlayer,-100164,15,0.300000,0.300000,0.300000,99,93,6,false,0,6,143
ReactivePlayer,-26283,15,0.300000,0.300000,0.300000,27,15,12,true,1,12,96
ReactivePlayer,-74408,15,0.300000,0.300000,0.300000,74,53,21,true,1,21,179
ReactivePlayer,-57892,15,0.300000,0.300000,0.300000,58,48,10,true,1,10,139
ReactivePlayer,-22395,15,0.300000,0.300000,0.300000,23,17,6,true,1,6,77
ReactivePlayer,-46573,15,0.300000,0.300000,0.300000,47,36,11,true,1,11,134
ReactivePlayer,-61186,15,0.300000,0.300000,0.300000,61,53,8,true,1,8,171
ReactivePlayer,-59531,15,0.300000,0.300000,0.300000,60,49,11,true,1,11,108
ReactivePlayer,-25356,15,0.300000,0.300000,0.300000,26,13,13,true,1,13,115
ReactivePlayer,-100349,15,0.300000,0.300000,0.300000,98,78,20,false,0,20,211
ReactivePlayer,-90919,15,0.300000,0.300000,0.300000,91,81,10,true,1,10,162
ReactivePlayer,-27539,15,0.300000,0.300000,0.300000,28,25,3,true,1,3,73
ReactivePlayer,-100002,15,0.300000,0.300000,0.300000,99,86,13,false,0,13,152
ReactivePlayer,-100786,15,0.300000,0.300000,0.300000,100,96,4,false,0,4,127
ReactivePlayer,-29256,15,0.300000,0.300000,0.300000,30,27,3,true,1,3,24
ReactivePlayer,-100664,15,0.300000,0.300000,0.300000,100,91,9,false,0,9,78
ReactivePlayer,-100627,15,0.300000,0.300000,0.300000,99,88,11,false,0,11,183
ReactivePlayer,-57012,15,0.300000,0.300000,0.300000,57,47,10,true,1,10,139
ReactivePlayer,-18211,15,0.300000,0.300000,0.300000,19,17,2,true,1,2,74
ReactivePlayer,-100464,15,0.300000,0.300000,0.300000,99,83,16,false,0,16,173
ReactivePlayer,-3052,15,0.300000,0.300000,0.300000,4,4,0,true,1,0,19
ReactivePlayer,-100693,15,0.300000,0.300000,0.300000,99,84,15,false,0,15,165
ReactivePlayer,-38403,15,0.300000,0.300000,0.300000,39,30,9,true,1,9,112
ReactivePlayer,-100114,15,0.300000,0.300000,0.300000,99,87,12,false,0,12,138
ReactivePlayer,-100331,15,0.300000,0.300000,0.300000,99,88,11,false,0,11,152
ReactivePlayer,-17294,15,0.300000,0.300000,0.300000,18,11,7,true,1,7,87
ReactivePlayer,-100130,15,0.300000,0.300000,0.300000,99,87,12,false,0,12,171
ReactivePlayer,-22496,15,0.300000,0.300000,0.300000,23,21,2,true,1,2,89
ReactivePlayer,-86030,15,0.300000,0.300000,0.300000,86,74,12,true,1,12,173
ReactivePlayer,-100067,15,0.300000,0.300000,0.300000,99,98,1,false,0,1,103
ReactivePlayer,-8139,15,0.300000,0.300000,0.300000,9,8,1,true,1,1,31
ReactivePlayer,-26,15,0.300000,0.300000,0.300000,1,1,0,true,1,0,15
ReactivePlayer,-10232,15,0.300000,0.300000,0.300000,11,8,3,true,1,3,46
ReactivePlayer,-29715,15,0.300000,0.300000,0.300000,30,23,7,true,1,7,134
ReactivePlayer,-95341,15,0.300000,0.300000,0.300000,95,74,21,true,1,21,196
ReactivePlayer,-30554,15,0.300000,0.300000,0.300000,31,23,8,true,1,8,132
ReactivePlayer,-28377,15,0.300000,0.300000,0.300000,29,23,6,true,1,6,76
ReactivePlayer,-100106,15,0.300000,0.300000,0.300000,99,85,14,false,0,14,157
ReactivePlayer,-1028,15,0.300000,0.300000,0.300000,2,1,1,true,1,1,21
ReactivePlayer,-100780,15,0.300000,0.300000,0.300000,100,82,18,false,0,18,166
ReactivePlayer,-50520,15,0.300000,0.300000,0.300000,51,42,9,true,1,9,132
ReactivePlayer,-46312,15,0.300000,0.300000,0.300000,47,33,14,true,1,14,96
ReactivePlayer,-100908,15,0.300000,0.300000,0.300000,100,91,9,false,0,9,97
ReactivePlayer,-62645,15,0.300000,0.300000,0.300000,62,49,13,true,1,13,171
ReactivePlayer,-7197,15,0.300000,0.300000,0.300000,8,0,8,true,1,8,53
ReactivePlayer,-100490,15,0.300000,0.300000,0.300000,99,89,10,false,0,10,183
ReactivePlayer,-30472,15,0.300000,0.300000,0.300000,31,24,7,true,1,7,129
ReactivePlayer,-100604,15,0.300000,0.300000,0.300000,99,80,19,false,0,19,203
ReactivePlayer,-100774,15,0.300000,0.300000,0.300000,100,94,6,false,0,6,153
ReactivePlayer,-38249,15,0.300000,0.300000,0.300000,39,35,4,true,1,4,68
ReactivePlayer,-42684,15,0.300000,0.300000,0.300000,43,41,2,true,1,2,91
ReactivePlayer,-66789,15,0.300000,0.300000,0.300000,67,57,10,true,1,10,100
ReactivePlayer,-80836,15,0.300000,0.300000,0.300000,81,76,5,true,1,5,142
ReactivePlayer,-100784,15,0.300000,0.300000,0.300000,100,91,9,false,0,9,148
ReactivePlayer,-56431,15,0.300000,0.300000,0.300000,56,40,16,true,1,16,186
ReactivePlayer,-100423,15,0.300000,0.300000,0.300000,99,82,17,false,0,17,197
ReactivePlayer,1000,15,0.300000,0.300000,0.300000,0,0,0,true,1,0,0
ReactivePlayer,-100068,15,0.300000,0.300000,0.300000,99,83,16,false,0,16,188
ReactivePlayer,-42570,15,0.300000,0.300000,0.300000,43,32,11,true,1,11,106
ReactivePlayer,-3026,15,0.300000,0.300000,0.300000,4,4,0,true,1,0,17
ReactivePlayer,-100994,15,0.300000,0.300000,0.300000,99,78,21,false,0,21,215
ReactivePlayer,-100085,15,0.300000,0.300000,0.300000,99,90,9,false,0,9,145
ReactivePlayer,-47391,15,0.300000,0.300000,0.300000,48,37,11,true,1,11,102
ReactivePlayer,-17235,15,0.300000,0.300000,0.300000,18,14,4,true,1,4,58
ReactivePlayer,-32466,15,0.300000,0.300000,0.300000,33,27,6,true,1,6,117
ReactivePlayer,-66604,15,0.300000,0.300000,0.300000,67,60,7,true,1,7,127
ReactivePlayer,-71805,15,0.300000,0.300000,0.300000,72,63,9,true,1,9,124
ReactivePlayer,992,15,0.300000,0.300000,0.300000,0,0,0,true,1,0,7
ReactivePlayer,-16323,15,0.300000,0.300000,0.300000,17,13,4,true,1,4,50
ReactivePlayer,-4097,15,0.300000,0.300000,0.300000,5,3,2,true,1,2,45
ReactivePlayer,-2029,15,0.300000,0.300000,0.300000,3,2,1,true,1,1,21
ReactivePlayer,-72074,15,0.300000,0.300000,0.300000,72,63,9,true,1,9,141
ReactivePlayer,-60491,15,0.300000,0.300000,0.300000,61,49,12,true,1,12,136
ReactivePlayer,-100541,15,0.300000,0.300000,0.300000,99,95,4,false,0,4,160
ReactivePlayer,-15198,15,0.300000,0.300000,0.300000,16,14,2,true,1,2,62
ReactivePlayer,-33237,15,0.300000,0.300000,0.300000,34,30,4,true,1,4,59
ReactivePlayer,-100727,15,0.300000,0.300000,0.300000,99,85,14,false,0,14,198
ReactivePlayer,-100025,15,0.300000,0.300000,0.300000,99,86,13,false,0,13,170
ReactivePlayer,-4040,15,0.300000,0.300000,0.300000,5,3,2,true,1,2,20
ReactivePlayer,-100000,15,0.300000,0.300000,0.300000,99,90,9,false,0,9,115
ReactivePlayer,-41684,15,0.300000,0.300000,0.300000,42,38,4,true,1,4,117
ReactivePlayer,-39611,15,0.300000,0.300000,0.300000,40,26,14,true,1,14,133
ReactivePlayer,-29423,15,0.300000,0.300000,0.300000,30,20,10,true,1,10,129
ReactivePlayer,-100159,15,0.300000,0.300000,0.300000,99,86,13,false,0,13,157
ReactivePlayer,-97068,15,0.300000,0.300000,0.300000,96,82,14,true,1,14,209
ReactivePlayer,-72563,15,0.300000,0.300000,0.300000,73,66,7,true,1,7,75
ReactivePlayer,-31335,15,0.300000,0.300000,0.300000,32,24,8,true,1,8,75
ReactivePlayer,-3069,15,0.300000,0.300000,0.300000,4,1,3,true,1,3,40
ReactivePlayer,-8082,15,0.300000,0.300000,0.300000,9,6,3,true,1,3,35
ReactivePlayer,-100161,15,0.300000,0.300000,0.300000,98,87,11,false,0,11,195
ReactivePlayer,-100511,15,0.300000,0.300000,0.300000,100,91,9,false,0,9,76
ReactivePlayer,-100238,15,0.300000,0.300000,0.300000,99,88,11,false,0,11,153
ReactivePlayer,-98035,15,0.300000,0.300000,0.300000,98,88,10,true,1,10,157
ReactivePlayer,-15072,15,0.300000,0.300000,0.300000,16,14,2,true,1,2,32
ReactivePlayer,-92323,15,0.300000,0.300000,0.300000,92,80,12,true,1,12,162
ReactivePlayer,-33322,15,0.300000,0.300000,0.300000,34,28,6,true,1,6,50
ReactivePlayer,-34688,15,0.300000,0.300000,0.300000,35,26,9,true,1,9,107
ReactivePlayer,-31778,15,0.300000,0.300000,0.300000,32,21,11,true,1,11,118
ReactivePlayer,-10403,15,0.300000,0.300000,0.300000,11,6,5,true,1,5,43
ReactivePlayer,-100018,15,0.300000,0.300000,0.300000,99,89,10,false,0,10,129
ReactivePlayer,-100295,15,0.300000,0.300000,0.300000,99,87,12,false,0,12,180
ReactivePlayer,-100711,15,0.300000,0.300000,0.300000,99,89,10,false,0,10,179
ReactivePlayer,-2018,15,0.300000,0.300000,0.300000,3,2,1,true,1,1,15
ReactivePlayer,-90189,15,0.300000,0.300000,0.300000,90,81,9,true,1,9,155
ReactivePlayer,-100272,15,0.300000,0.300000,0.300000,99,91,8,false,0,8,149
ReactivePlayer,-17358,15,0.300000,0.300000,0.300000,18,12,6,true,1,6,116
ReactivePlayer,-34371,15,0.300000,0.300000,0.300000,35,26,9,true,1,9,106
ReactivePlayer,-49661,15,0.300000,0.300000,0.300000,50,43,7,true,1,7,155
ReactivePlayer,-9120,15,0.300000,0.300000,0.300000,10,9,1,true,1,1,36
ReactivePlayer,-12293,15,0.300000,0.300000,0.300000,13,8,5,true,1,5,63
ReactivePlayer,-44825,15,0.300000,0.300000,0.300000,45,34,11,true,1,11,162
ReactivePlayer,-100667,15,0.300000,0.300000,0.300000,100,97,3,false,0,3,80
ReactivePlayer,-100975,15,0.300000,0.300000,0.300000,99,87,12,false,0,12,197
ReactivePlayer,-100485,15,0.300000,0.300000,0.300000,99,86,13,false,0,13,162
ReactivePlayer,-5149,15,0.300000,0.300000,0.300000,6,3,3,true,1,3,71
ReactivePlayer,-100871,15,0.300000,0.300000,0.300000,99,75,24,false,0,24,203
ReactivePlayer,-100498,15,0.300000,0.300000,0.300000,99,83,16,false,0,16,190
ReactivePlayer,-100783,15,0.300000,0.300000,0.300000,100,93,7,false,0,7,138
ReactivePlayer,-6095,15,0.300000,0.300000,0.300000,7,7,0,true,1,0,20
ReactivePlayer,-100486,15,0.300000,0.300000,0.300000,99,89,10,false,0,10,120
ReactivePlayer,-93956,15,0.300000,0.300000,0.300000,94,76,18,true,1,18,178
ReactivePlayer,-90629,15,0.300000,0.300000,0.300000,90,74,16,true,1,16,203
ReactivePlayer,-11161,15,0.300000,0.300000,0.300000,12,11,1,true,1,1,46
ReactivePlayer,-100929,15,0.300000,0.300000,0.300000,100,87,13,false,0,13,131
ReactivePlayer,-84914,15,0.300000,0.300000,0.300000,85,67,18,true,1,18,145
ReactivePlayer,-15154,15,0.300000,0.300000,0.300000,16,14,2,true,1,2,49
ReactivePlayer,-100866,15,0.300000,0.300000,0.300000,100,90,10,false,0,10,161
ReactivePlayer,-69573,15,0.300000,0.300000,0.300000,70,64,6,true,1,6,93
ReactivePlayer,-63,15,0.300000,0.300000,0.300000,1,0,1,true,1,1,24
ReactivePlayer,-22238,15,0.300000,0.300000,0.300000,23,15,8,true,1,8,89
ReactivePlayer,-8,15,0.300000,0.300000,0.300000,1,1,0,true,1,0,6
ReactivePlayer,-11093,15,0.300000,0.300000,0.300000,12,10,2,true,1,2,15
ReactivePlayer,-100195,15,0.300000,0.300000,0.300000,99,82,17,false,0,17,181
ReactivePlayer,-100348,15,0.300000,0.300000,0.300000,99,84,15,false,0,15,169
ReactivePlayer,-1025,15,0.300000,0.300000,0.300000,2,1,1,true,1,1,13
ReactivePlayer,-31265,15,0.300000,0.300000,0.300000,32,28,4,true,1,4,88
ReactivePlayer,-73117,15,0.300000,0.300000,0.300000,73,62,11,true,1,11,147
ReactivePlayer,-6040,15,0.300000,0.300000,0.300000,7,6,1,true,1,1,20
ReactivePlayer,-12265,15,0.300000,0.300000,0.300000,13,9,4,true,1,4,88
ReactivePlayer,-32202,15,0.300000,0.300000,0.300000,33,29,4,true,1,4,48
ReactivePlayer,-5048,15,0.300000,0.300000,0.300000,6,5,1,true,1,1,26
ReactivePlayer,-96698,15,0.300000,0.300000,0.300000,96,84,12,true,1,12,153
ReactivePlayer,-2091,15,0.300000,0.300000,0.300000,3,0,3,true,1,3,40
ReactivePlayer,-46861,15,0.300000,0.300000,0.300000,47,39,8,true,1,8,114
ReactivePlayer,-100181,15,0.300000,0.300000,0.300000,99,89,10,false,0,10,161
ReactivePlayer,-98643,15,0.300000,0.300000,0.300000,98,90,8,true,1,8,184
ReactivePlayer,-100204,15,0.300000,0.300000,0.300000,99,93,6,false,0,6,146
ReactivePlayer,-100323,15,0.300000,0.300000,0.300000,99,90,9,false,0,9,142
ReactivePlayer,-100990,15,0.300000,0.300000,0.300000,99,87,12,false,0,12,214
ReactivePlayer,-93103,15,0.300000,0.300000,0.300000,93,80,13,true,1,13,159
ReactivePlayer,-100480,15,0.300000,0.300000,0.300000,99,85,14,false,0,14,214
ReactivePlayer,-71944,15,0.300000,0.300000,0.300000,72,61,11,true,1,11,153
ReactivePlayer,-10172,15,0.300000,0.300000,0.300000,11,6,5,true,1,5,47
ReactivePlayer,-44,15,0.300000,0.300000,0.300000,1,0,1,true,1,1,17
ReactivePlayer,-1091,15,0.300000,0.300000,0.300000,2,0,2,true,1,2,39
ReactivePlayer,-29369,15,0.300000,0.300000,0.300000,30,23,7,true,1,7,96
ReactivePlayer,-100371,15,0.300000,0.300000,0.300000,99,86,13,false,0,13,185
ReactivePlayer,-58277,15,0.300000,0.300000,0.300000,58,56,2,true,1,2,96
ReactivePlayer,-42978,15,0.300000,0.300000,0.300000,43,33,10,true,1,10,161
ReactivePlayer,-54826,15,0.300000,0.300000,0.300000,55,37,18,true,1,18,154
ReactivePlayer,-20518,15,0.300000,0.300000,0.300000,21,15,6,true,1,6,91
ReactivePlayer,-71013,15,0.300000,0.300000,0.300000,71,61,10,true,1,10,135
ReactivePlayer,-10064,15,0.300000,0.300000,0.300000,11,8,3,true,1,3,37
ReactivePlayer,-100439,15,0.300000,0.300000,0.300000,99,83,16,false,0,16,165
ReactivePlayer,-9167,15,0.300000,0.300000,0.300000,10,9,1,true,1,1,33
ReactivePlayer,-51442,15,0.300000,0.300000,0.300000,52,39,13,true,1,13,95
ReactivePlayer,-100022,15,0.300000,0.300000,0.300000,99,83,16,false,0,16,163
ReactivePlayer,-100692,15,0.300000,0.300000,0.300000,100,87,13,false,0,13,86
ReactivePlayer,-29198,15,0.300000,0.300000,0.300000,30,24,6,true,1,6,69
ReactivePlayer,-100266,15,0.300000,0.300000,0.300000,99,92,7,false,0,7,126
ReactivePlayer,-96753,15,0.300000,0.300000,0.300000,96,83,13,true,1,13,190
ReactivePlayer,-44667,15,0.300000,0.300000,0.300000,45,36,9,true,1,9,141
ReactivePlayer,-14,15,0.300000,0.300000,0.300000,1,0,1,true,1,1,9
ReactivePlayer,-13114,15,0.300000,0.300000,0.300000,14,10,4,true,1,4,44
ReactivePlayer,-100481,15,0.300000,0.300000,0.300000,99,86,13,false,0,13,171
ReactivePlayer,-100133,15,0.300000,0.300000,0.300000,99,82,17,false,0,17,170
ReactivePlayer,-4143,15,0.300000,0.300000,0.300000,5,3,2,true,1,2,31
ReactivePlayer,-92910,15,0.300000,0.300000,0.300000,93,91,2,true,1,2,61
ReactivePlayer,-26368,15,0.300000,0.300000,0.300000,27,18,9,true,1,9,90
ReactivePlayer,993,15,0.300000,0.300000,0.300000,0,0,0,true,1,0,5
ReactivePlayer,-100130,15,0.300000,0.300000,0.300000,99,96,3,false,0,3,107
ReactivePlayer,-72761,15,0.300000,0.300000,0.300000,73,64,9,true,1,9,164
ReactivePlayer,-16577,15,0.300000,0.300000,0.300000,17,11,6,true,1,6,106
ReactivePlayer,-100151,15,0.300000,0.300000,0.300000,99,84,15,false,0,15,156
ReactivePlayer,-100233,15,0.300000,0.300000,0.300000,99,92,7,false,0,7,162
ReactivePlayer,-52798,15,0.300000,0.300000,0.300000,53,42,11,true,1,11,133
ReactivePlayer,-27425,15,0.300000,0.300000,0.300000,28,27,1,true,1,1,91
ReactivePlayer,-50492,15,0.300000,0.300000,0.300000,51,37,14,true,1,14,129
ReactivePlayer,-100355,15,0.300000,0.300000,0.300000,99,85,14,false,0,14,186
ReactivePlayer,-5091,15,0.300000,0.300000,0.300000,6,5,1,true,1,1,18
ReactivePlayer,-100136,15,0.300000,0.300000,0.300000,99,90,9,false,0,9,155
ReactivePlayer,-100349,15,0.300000,0.300000,0.300000,99,92,7,false,0,7,128
ReactivePlayer,-100853,15,0.300000,0.300000,0.300000,99,87,12,false,0,12,163
ReactivePlayer,-62107,15,0.300000,0.300000,0.300000,62,54,8,true,1,8,174
ReactivePlayer,-100515,15,0.300000,0.300000,0.300000,99,90,9,false,0,9,179
ReactivePlayer,-100026,15,0.300000,0.300000,0.300000,99,83,16,false,0,16,127
ReactivePlayer,-54848,15,0.300000,0.300000,0.300000,55,39,16,true,1,16,127
ReactivePlayer,-100267,15,0.300000,0.300000,0.300000,99,91,8,false,0,8,166
ReactivePlayer,-53213,15,0.300000,0.300000,0.300000,53,42,11,true,1,11,178
ReactivePlayer,-100133,15,0.300000,0.300000,0.300000,99,86,13,false,0,13,148
ReactivePlayer,-62877,15,0.300000,0.300000,0.300000,63,52,11,true,1,11,160
ReactivePlayer,-87576,15,0.300000,0.300000,0.300000,87,72,15,true,1,15,215
ReactivePlayer,-100260,15,0.300000,0.300000,0.300000,99,94,5,false,0,5,122
ReactivePlayer,-100319,15,0.300000,0.300000,0.300000,99,87,12,false,0,12,190
ReactivePlayer,-10131,15,0.300000,0.300000,0.300000,11,9,2,true,1,2,41
ReactivePlayer,-32530,15,0.300000,0.300000,0.300000,33,22,11,true,1,11,134
ReactivePlayer,-15445,15,0.300000,0.300000,0.300000,16,11,5,true,1,5,100
ReactivePlayer,-9251,15,0.300000,0.300000,0.300000,10,2,8,true,1,8,70
ReactivePlayer,-44610,15,0.300000,0.300000,0.300000,45,35,10,true,1,10,113
ReactivePlayer,-73333,15,0.300000,0.300000,0.300000,72,55,17,true,1,17,188
ReactivePlayer,-52506,15,0.300000,0.300000,0.300000,53,49,4,true,1,4,106
ReactivePlayer,-40524,15,0.300000,0.300000,0.300000,41,31,10,true,1,10,132
ReactivePlayer,-100946,15,0.300000,0.300000,0.300000,100,84,16,false,0,16,153
ReactivePlayer,-76914,15,0.300000,0.300000,0.300000,77,69,8,true,1,8,84
ReactivePlayer,-14382,15,0.300000,0.300000,0.300000,15,11,4,true,1,4,61
ReactivePlayer,-100924,15,0.300000,0.300000,0.300000,100,92,8,false,0,8,136
ReactivePlayer,-100767,15,0.300000,0.300000,0.300000,100,93,7,false,0,7,143
ReactivePlayer,-27404,15,0.300000,0.300000,0.300000,28,18,10,true,1,10,111
ReactivePlayer,-33404,15,0.300000,0.300000,0.300000,34,26,8,true,1,8,113
ReactivePlayer,-100287,15,0.300000,0.300000,0.300000,99,87,12,false,0,12,176
ReactivePlayer,-51007,15,0.300000,0.300000,0.300000,51,42,9,true,1,9,154
ReactivePlayer,-17269,15,0.300000,0.300000,0.300000,18,11,7,true,1,7,84
ReactivePlayer,-100669,15,0.300000,0.300000,0.300000,99,82,17,false,0,17,171
ReactivePlayer,-100993,15,0.300000,0.300000,0.300000,100,85,15,false,0,15,153
ReactivePlayer,-26317,15,0.300000,0.300000,0.300000,27,25,2,true,1,2,62
ReactivePlayer,-2235,15,0.300000,0.300000,0.300000,3,2,1,true,1,1,51
ReactivePlayer,-58403,15,0.300000,0.300000,0.300000,59,55,4,true,1,4,71
ReactivePlayer,-8089,15,0.300000,0.300000,0.300000,9,6,3,true,1,3,25
ReactivePlayer,-26303,15,0.300000,0.300000,0.300000,27,24,3,true,1,3,47
ReactivePlayer,-24335,15,0.300000,0.300000,0.300000,25,17,8,true,1,8,73
ReactivePlayer,-100022,15,0.300000,0.300000,0.300000,99,82,17,false,0,17,205
ReactivePlayer,-14102,15,0.300000,0.300000,0.300000,15,14,1,true,1,1,22
ReactivePlayer,-100416,15,0.300000,0.300000,0.300000,99,85,14,false,0,14,200
ReactivePlayer,-100425,15,0.300000,0.300000,0.300000,99,78,21,false,0,21,182
ReactivePlayer,-16278,15,0.300000,0.300000,0.300000,17,11,6,true,1,6,82
ReactivePlayer,-30671,15,0.300000,0.300000,0.300000,31,22,9,true,1,9,121
ReactivePlayer,-5104,15,0.300000,0.300000,0.300000,6,6,0,true,1,0,19
ReactivePlayer,-11099,15,0.300000,0.300000,0.300000,12,9,3,true,1,3,26
ReactivePlayer,-100065,15,0.300000,0.300000,0.300000,99,85,14,false,0,14,171
ReactivePlayer,-2147,15,0.300000,0.300000,0.300000,3,3,0,true,1,0,29
ReactivePlayer,-53230,15,0.300000,0.300000,0.300000,53,43,10,true,1,10,143
ReactivePlayer,-35264,15,0.300000,0.300000,0.300000,36,31,5,true,1,5,77
ReactivePlayer,-1098,15,0.300000,0.300000,0.300000,2,1,1,true,1,1,35
ReactivePlayer,-100663,15,0.300000,0.300000,0.300000,100,90,10,false,0,10,90
ReactivePlayer,-71943,15,0.300000,0.300000,0.300000,72,67,5,true,1,5,96
ReactivePlayer,-42414,15,0.300000,0.300000,0.300000,43,36,7,true,1,7,111
ReactivePlayer,-100678,15,0.300000,0.300000,0.300000,99,81,18,false,0,18,157
ReactivePlayer,-8078,15,0.300000,0.300000,0.300000,9,7,2,true,1,2,25
ReactivePlayer,-42654,15,0.300000,0.300000,0.300000,43,34,9,true,1,9,116
ReactivePlayer,-3019,15,0.300000,0.300000,0.300000,4,1,3,true,1,3,12
ReactivePlayer,-24223,15,0.300000,0.300000,0.300000,25,21,4,true,1,4,70
ReactivePlayer,-100249,15,0.300000,0.300000,0.300000,99,88,11,false,0,11,151
ReactivePlayer,-100792,15,0.300000,0.300000,0.300000,100,93,7,false,0,7,128
ReactivePlayer,-32489,15,0.300000,0.300000,0.300000,33,20,13,true,1,13,95
ReactivePlayer,-11113,15,0.300000,0.300000,0.300000,12,10,2,true,1,2,49
ReactivePlayer,-40464,15,0.300000,0.300000,0.300000,41,32,9,true,1,9,130
ReactivePlayer,-39504,15,0.300000,0.300000,0.300000,40,32,8,true,1,8,81
ReactivePlayer,-100865,15,0.300000,0.300000,0.300000,99,85,14,false,0,14,145
ReactivePlayer,-100119,15,0.300000,0.300000,0.300000,99,90,9,false,0,9,139
ReactivePlayer,-29566,15,0.300000,0.300000,0.300000,30,19,11,true,1,11,158
ReactivePlayer,-100198,15,0.300000,0.300000,0.300000,99,88,11,false,0,11,179
ReactivePlayer,-34403,15,0.300000,0.300000,0.300000,35,19,16,true,1,16,103
ReactivePlayer,-32384,15,0.300000,0.300000,0.300000,33,23,10,true,1,10,111
ReactivePlayer,-100952,15,0.300000,0.300000,0.300000,100,94,6,false,0,6,82
ReactivePlayer,-24229,15,0.300000,0.300000,0.300000,25,21,4,true,1,4,70
ReactivePlayer,-100973,15,0.300000,0.300000,0.300000,100,95,5,false,0,5,46
ReactivePlayer,-29295,15,0.300000,0.300000,0.300000,30,20,10,true,1,10,91
ReactivePlayer,-45761,15,0.300000,0.300000,0.300000,46,43,3,true,1,3,64
ReactivePlayer,-17210,15,0.300000,0.300000,0.300000,18,15,3,true,1,3,44
ReactivePlayer,-11089,15,0.300000,0.300000,0.300000,12,12,0,true,1,0,28
ReactivePlayer,-49711,15,0.300000,0.300000,0.300000,50,43,7,true,1,7,123
ReactivePlayer,-36444,15,0.300000,0.300000,0.300000,37,36,1,true,1,1,96
ReactivePlayer,-100272,15,0.300000,0.300000,0.300000,99,86,13,false,0,13,175
ReactivePlayer,-4225,15,0.300000,0.300000,0.300000,5,4,1,true,1,1,80
ReactivePlayer,-17275,15,0.300000,0.300000,0.300000,18,12,6,true,1,6,100
ReactivePlayer,-35563,15,0.300000,0.300000,0.300000,36,28,8,true,1,8,109
ReactivePlayer,-23146,15,0.300000,0.300000,0.300000,24,23,1,true,1,1,51
ReactivePlayer,-19392,15,0.300000,0.300000,0.300000,20,12,8,true,1,8,86
ReactivePlayer,-11131,15,0.300000,0.300000,0.300000,12,6,6,true,1,6,57
ReactivePlayer,-75857,15,0.300000,0.300000,0.300000,76,54,22,true,1,22,184
ReactivePlayer,-1010,15,0.300000,0.300000,0.300000,2,0,2,true,1,2,8
ReactivePlayer,-100321,15,0.300000,0.300000,0.300000,99,84,15,false,0,15,150
ReactivePlayer,-16128,15,0.300000,0.300000,0.300000,17,11,6,true,1,6,59
ReactivePlayer,-41085,15,0.300000,0.300000,0.300000,41,33,8,true,1,8,155
ReactivePlayer,-25006,15,0.300000,0.300000,0.300000,25,20,5,true,1,5,137
ReactivePlayer,-8110,15,0.300000,0.300000,0.300000,9,6,3,true,1,3,46
ReactivePlayer,-100545,15,0.300000,0.300000,0.300000,99,96,3,false,0,3,106
ReactivePlayer,-100199,15,0.300000,0.300000,0.300000,99,82,17,false,0,17,168
ReactivePlayer,-3081,15,0.300000,0.300000,0.300000,4,2,2,true,1,2,38
ReactivePlayer,-100501,15,0.300000,0.300000,0.300000,99,87,12,false,0,12,158
ReactivePlayer,-16130,15,0.300000,0.300000,0.300000,17,13,4,true,1,4,51
ReactivePlayer,-100916,15,0.300000,0.300000,0.300000,100,86,14,false,0,14,133
ReactivePlayer,-27311,15,0.300000,0.300000,0.300000,28,25,3,true,1,3,100
ReactivePlayer,-100758,15,0.300000,0.300000,0.300000,99,88,11,false,0,11,161
ReactivePlayer,-49675,15,0.300000,0.300000,0.300000,50,44,6,true,1,6,129
ReactivePlayer,-100189,15,0.300000,0.300000,0.300000,99,96,3,false,0,3,101
ReactivePlayer,-64409,15,0.300000,0.300000,0.300000,65,57,8,true,1,8,116
ReactivePlayer,1000,15,0.300000,0.300000,0.300000,0,0,0,true,1,0,0
ReactivePlayer,-98911,15,0.300000,0.300000,0.300000,99,81,18,true,1,18,162
ReactivePlayer,-25510,15,0.300000,0.300000,0.300000,26,13,13,true,1,13,109
ReactivePlayer,-10081,15,0.300000,0.300000,0.300000,11,7,4,true,1,4,44
ReactivePlayer,-100339,15,0.300000,0.300000,0.300000,99,88,11,false,0,11,174
ReactivePlayer,-2051,15,0.300000,0.300000,0.300000,3,0,3,true,1,3,29
ReactivePlayer,-17659,15,0.300000,0.300000,0.300000,18,12,6,true,1,6,84
ReactivePlayer,-15255,15,0.300000,0.300000,0.300000,16,11,5,true,1,5,110
ReactivePlayer,-66360,15,0.300000,0.300000,0.300000,66,52,14,true,1,14,202
ReactivePlayer,987,15,0.300000,0.300000,0.300000,0,0,0,true,1,0,7
ReactivePlayer,-23378,15,0.300000,0.300000,0.300000,24,15,9,true,1,9,88
ReactivePlayer,-3039,15,0.300000,0.300000,0.300000,4,3,1,true,1,1,17
ReactivePlayer,-76049,15,0.300000,0.300000,0.300000,76,69,7,true,1,7,129
ReactivePlayer,-26307,15,0.300000,0.300000,0.300000,27,20,7,true,1,7,82
ReactivePlayer,-30599,15,0.300000,0.300000,0.300000,31,24,7,true,1,7,149
ReactivePlayer,-100028,15,0.300000,0.300000,0.300000,99,83,16,false,0,16,185
ReactivePlayer,-17285,15,0.300000,0.300000,0.300000,18,14,4,true,1,4,70
ReactivePlayer,-19170,15,0.300000,0.300000,0.300000,20,14,6,true,1,6,59
ReactivePlayer,-100255,15,0.300000,0.300000,0.300000,99,83,16,false,0,16,150
ReactivePlayer,-16210,15,0.300000,0.300000,0.300000,17,12,5,true,1,5,59
ReactivePlayer,-11327,15,0.300000,0.300000,0.300000,12,6,6,true,1,6,70
ReactivePlayer,-3233,15,0.300000,0.300000,0.300000,4,0,4,true,1,4,36
ReactivePlayer,-5031,15,0.300000,0.300000,0.300000,6,3,3,true,1,3,19
ReactivePlayer,-100391,15,0.300000,0.300000,0.300000,99,90,9,false,0,9,129
ReactivePlayer,-4082,15,0.300000,0.300000,0.300000,5,4,1,true,1,1,42
ReactivePlayer,-3140,15,0.300000,0.300000,0.300000,4,1,3,true,1,3,37
ReactivePlayer,-12181,15,0.300000,0.300000,0.300000,13,9,4,true,1,4,63
ReactivePlayer,-9092,15,0.300000,0.300000,0.300000,10,8,2,true,1,2,37
ReactivePlayer,-100143,15,0.300000,0.300000,0.300000,99,78,21,false,0,21,175
ReactivePlayer,-71980,15,0.300000,0.300000,0.300000,72,61,11,true,1,11,163
ReactivePlayer,-100665,15,0.300000,0.300000,0.300000,99,88,11,false,0,11,207
ReactivePlayer,-100338,15,0.300000,0.300000,0.300000,99,87,12,false,0,12,175
ReactivePlayer,-87151,15,0.300000,0.300000,0.300000,87,71,16,true,1,16,185
ReactivePlayer,-100506,15,0.300000,0.300000,0.300000,99,84,15,false,0,15,199
ReactivePlayer,-12337,15,0.300000,0.300000,0.300000,13,8,5,true,1,5,91
ReactivePlayer,-58603,15,0.300000,0.300000,0.300000,59,49,10,true,1,10,134
ReactivePlayer,-100158,15,0.300000,0.300000,0.300000,99,84,15,false,0,15,182
ReactivePlayer,-100321,15,0.300000,0.300000,0.300000,99,87,12,false,0,12,173
ReactivePlayer,-6111,15,0.300000,0.300000,0.300000,7,3,4,true,1,4,36
ReactivePlayer,-4072,15,0.300000,0.300000,0.300000,5,2,3,true,1,3,38
ReactivePlayer,-29239,15,0.300000,0.300000,0.300000,30,24,6,true,1,6,89
ReactivePlayer,-57553,15,0.300000,0.300000,0.300000,58,45,13,true,1,13,139
ReactivePlayer,-89621,15,0.300000,0.300000,0.300000,89,74,15,true,1,15,171
ReactivePlayer,-45762,15,0.300000,0.300000,0.300000,46,32,14,true,1,14,123
ReactivePlayer,-100672,15,0.300000,0.300000,0.300000,99,85,14,false,0,14,192
ReactivePlayer,-100968,15,0.300000,0.300000,0.300000,100,90,10,false,0,10,174
ReactivePlayer,-100972,15,0.300000,0.300000,0.300000,100,87,13,false,0,13,187
ReactivePlayer,-48621,15,0.300000,0.300000,0.300000,49,34,15,true,1,15,150
ReactivePlayer,-18238,15,0.300000,0.300000,0.300000,19,15,4,true,1,4,57
ReactivePlayer,905,15,0.300000,0.300000,0.300000,0,0,0,true,1,0,30
ReactivePlayer,-97171,15,0.300000,0.300000,0.300000,97,88,9,true,1,9,106
ReactivePlayer,-9097,15,0.300000,0.300000,0.300000,10,6,4,true,1,4,44
ReactivePlayer,-54876,15,0.300000,0.300000,0.300000,55,44,11,true,1,11,179
ReactivePlayer,-59808,15,0.300000,0.300000,0.300000,60,51,9,true,1,9,168
ReactivePlayer,-61809,15,0.300000,0.300000,0.300000,62,50,12,true,1,12,142
ReactivePlayer,-65216,15,0.300000,0.300000,0.300000,65,52,13,true,1,13,179
ReactivePlayer,-100049,15,0.300000,0.300000,0.300000,99,90,9,false,0,9,142
ReactivePlayer,-100710,15,0.300000,0.300000,0.300000,99,85,14,false,0,14,164
ReactivePlayer,-48904,15,0.300000,0.300000,0.300000,49,45,4,true,1,4,91
ReactivePlayer,-100537,15,0.300000,0.300000,0.300000,99,84,15,false,0,15,202
ReactivePlayer,-54817,15,0.300000,0.300000,0.300000,55,47,8,true,1,8,128
ReactivePlayer,-61475,15,0.300000,0.300000,0.300000,62,52,10,true,1,10,121
ReactivePlayer,-100441,15,0.300000,0.300000,0.300000,99,99,0,false,0,0,5
ReactivePlayer,-42289,15,0.300000,0.300000,0.300000,43,33,10,true,1,10,98
ReactivePlayer,-100556,15,0.300000,0.300000,0.300000,99,85,14,false,0,14,188
ReactivePlayer,-90930,15,0.300000,0.300000,0.300000,91,76,15,true,1,15,135
ReactivePlayer,-94338,15,0.300000,0.300000,0.300000,94,78,16,true,1,16,162
ReactivePlayer,-100484,15,0.300000,0.300000,0.300000,99,81,18,false,0,18,197
ReactivePlayer,-100798,15,0.300000,0.300000,0.300000,99,79,20,false,0,20,192
ReactivePlayer,-100803,15,0.300000,0.300000,0.300000,100,94,6,false,0,6,116
ReactivePlayer,-57236,15,0.300000,0.300000,0.300000,57,47,10,true,1,10,156
ReactivePlayer,-100106,15,0.300000,0.300000,0.300000,99,88,11,false,0,11,170
ReactivePlayer,-48348,15,0.300000,0.300000,0.300000,49,45,4,true,1,4,74
ReactivePlayer,1000,15,0.300000,0.300000,0.300000,0,0,0,true,1,0,0
ReactivePlayer,-100662,15,0.300000,0.300000,0.300000,99,90,9,false,0,9,169
ReactivePlayer,-100264,15,0.300000,0.300000,0.300000,99,86,13,false,0,13,165
ReactivePlayer,-38910,15,0.300000,0.300000,0.300000,39,26,13,true,1,13,154
ReactivePlayer,-100075,15,0.300000,0.300000,0.300000,99,88,11,false,0,11,155
ReactivePlayer,-26617,15,0.300000,0.300000,0.300000,27,26,1,true,1,1,105
ReactivePlayer,-100129,15,0.300000,0.300000,0.300000,99,90,9,false,0,9,142
ReactivePlayer,-17206,15,0.300000,0.300000,0.300000,18,15,3,true,1,3,42
ReactivePlayer,-27370,15,0.300000,0.300000,0.300000,28,23,5,true,1,5,76
ReactivePlayer,-100396,15,0.300000,0.300000,0.300000,99,80,19,false,0,19,218
ReactivePlayer,-54511,15,0.300000,0.300000,0.300000,55,45,10,true,1,10,117
ReactivePlayer,-37789,15,0.300000,0.300000,0.300000,38,30,8,true,1,8,131
ReactivePlayer,-40388,15,0.300000,0.300000,0.300000,41,26,15,true,1,15,121
ReactivePlayer,-100938,15,0.300000,0.300000,0.300000,100,86,14,false,0,14,115
ReactivePlayer,-41594,15,0.300000,0.300000,0.300000,42,36,6,true,1,6,93
ReactivePlayer,-100773,15,0.300000,0.300000,0.300000,100,91,9,false,0,9,157
ReactivePlayer,-100100,15,0.300000,0.300000,0.300000,99,85,14,false,0,14,172
ReactivePlayer,-31612,15,0.300000,0.300000,0.300000,32,19,13,true,1,13,166
ReactivePlayer,-29260,15,0.300000,0.300000,0.300000,30,24,6,true,1,6,92
ReactivePlayer,-41457,15,0.300000,0.300000,0.300000,42,35,7,true,1,7,100
ReactivePlayer,-10273,15,0.300000,0.300000,0.300000,11,2,9,true,1,9,92
ReactivePlayer,-49389,15,0.300000,0.300000,0.300000,50,40,10,true,1,10,102
ReactivePlayer,-62583,15,0.300000,0.300000,0.300000,63,50,13,true,1,13,151
ReactivePlayer,-42459,15,0.300000,0.300000,0.300000,43,39,4,true,1,4,89
ReactivePlayer,-1092,15,0.300000,0.300000,0.300000,2,2,0,true,1,0,36
ReactivePlayer,-100632,15,0.300000,0.300000,0.300000,99,91,8,false,0,8,115
ReactivePlayer,-100017,15,0.300000,0.300000,0.300000,99,91,8,false,0,8,160
ReactivePlayer,-47565,15,0.300000,0.300000,0.300000,48,37,11,true,1,11,139
ReactivePlayer,-100657,15,0.300000,0.300000,0.300000,100,88,12,false,0,12,109
ReactivePlayer,-100734,15,0.300000,0.300000,0.300000,99,88,11,false,0,11,173
ReactivePlayer,-100989,15,0.300000,0.300000,0.300000,100,91,9,false,0,9,143
ReactivePlayer,-38412,15,0.300000,0.300000,0.300000,39,31,8,true,1,8,102
ReactivePlayer,-65701,15,0.300000,0.300000,0.300000,66,58,8,true,1,8,165
ReactivePlayer,-100762,15,0.300000,0.300000,0.300000,99,89,10,false,0,10,184
ReactivePlayer,-15249,15,0.300000,0.300000,0.300000,16,10,6,true,1,6,72
ReactivePlayer,-32716,15,0.300000,0.300000,0.300000,33,26,7,true,1,7,150
ReactivePlayer,-68724,15,0.300000,0.300000,0.300000,68,54,14,true,1,14,178
ReactivePlayer,-69805,15,0.300000,0.300000,0.300000,70,56,14,true,1,14,148
ReactivePlayer,-13,15,0.300000,0.300000,0.300000,1,0,1,true,1,1,10
ReactivePlayer,-11261,15,0.300000,0.300000,0.300000,12,5,7,true,1,7,77
ReactivePlayer,-83225,15,0.300000,0.300000,0.300000,83,75,8,true,1,8,164
ReactivePlayer,-100836,15,0.300000,0.300000,0.300000,100,92,8,false,0,8,99
ReactivePlayer,-100021,15,0.300000,0.300000,0.300000,99,91,8,false,0,8,145
ReactivePlayer,-100689,15,0.300000,0.300000,0.300000,99,89,10,false,0,10,197
ReactivePlayer,-92078,15,0.300000,0.300000,0.300000,92,78,14,true,1,14,179
ReactivePlayer,-13433,15,0.300000,0.300000,0.300000,14,8,6,true,1,6,99
ReactivePlayer,-55701,15,0.300000,0.300000,0.300000,56,48,8,true,1,8,130
ReactivePlayer,-52445,15,0.300000,0.300000,0.300000,53,46,7,true,1,7,79
ReactivePlayer,-47114,15,0.300000,0.300000,0.300000,47,38,9,true,1,9,188
ReactivePlayer,-47434,15,0.300000,0.300000,0.300000,48,35,13,true,1,13,124
ReactivePlayer,-46505,15,0.300000,0.300000,0.300000,47,38,9,true,1,9,123
ReactivePlayer,1000,15,0.300000,0.300000,0.300000,0,0,0,true,1,0,0
ReactivePlayer,-33284,15,0.300000,0.300000,0.300000,34,29,5,true,1,5,62
ReactivePlayer,-1037,15,0.300000,0.300000,0.300000,2,0,2,true,1,2,17
ReactivePlayer,-1038,15,0.300000,0.300000,0.300000,2,1,1,true,1,1,25
ReactivePlayer,-13208,15,0.300000,0.300000,0.300000,14,9,5,true,1,5,74
ReactivePlayer,-1030,15,0.300000,0.300000,0.300000,2,2,0,true,1,0,23
ReactivePlayer,-20300,15,0.300000,0.300000,0.300000,21,15,6,true,1,6,76
ReactivePlayer,-1034,15,0.300000,0.300000,0.300000,2,0,2,true,1,2,18
ReactivePlayer,-100843,15,0.300000,0.300000,0.300000,100,93,7,false,0,7,134
ReactivePlayer,-19445,15,0.300000,0.300000,0.300000,20,8,12,true,1,12,137
ReactivePlayer,-7125,15,0.300000,0.300000,0.300000,8,5,3,true,1,3,37
ReactivePlayer,-26411,15,0.300000,0.300000,0.300000,27,17,10,true,1,10,99
ReactivePlayer,-97355,15,0.300000,0.300000,0.300000,97,84,13,true,1,13,170
ReactivePlayer,-100072,15,0.300000,0.300000,0.300000,99,92,7,false,0,7,143
ReactivePlayer,-100813,15,0.300000,0.300000,0.300000,99,82,17,false,0,17,197
ReactivePlayer,-62388,15,0.300000,0.300000,0.300000,63,55,8,true,1,8,115
ReactivePlayer,-70061,15,0.300000,0.300000,0.300000,70,57,13,true,1,13,140
ReactivePlayer,-88405,15,0.300000,0.300000,0.300000,88,79,9,true,1,9,153
ReactivePlayer,-100373,15,0.300000,0.300000,0.300000,99,89,10,false,0,10,157
ReactivePlayer,-72783,15,0.300000,0.300000,0.300000,73,63,10,true,1,10,132
ReactivePlayer,-30265,15,0.300000,0.300000,0.300000,31,27,4,true,1,4,91
ReactivePlayer,-6219,15,0.300000,0.300000,0.300000,7,4,3,true,1,3,52
ReactivePlayer,-17255,15,0.300000,0.300000,0.300000,18,14,4,true,1,4,83
ReactivePlayer,-4111,15,0.300000,0.300000,0.300000,5,3,2,true,1,2,37
ReactivePlayer,-100215,15,0.300000,0.300000,0.300000,99,90,9,false,0,9,104
ReactivePlayer,-100153,15,0.300000,0.300000,0.300000,99,89,10,false,0,10,150
ReactivePlayer,-49624,15,0.300000,0.300000,0.300000,50,40,10,true,1,10,137
ReactivePlayer,-84094,15,0.300000,0.300000,0.300000,84,69,15,true,1,15,176
