Player Type,Total Score,World Size,Wumpus Probability,Obstacle Probability,Pit Probability,Total Deaths,Pit Deaths,Wumpus Deaths,Have gold,Have gold int,WumpusKilled,RoomsExplored
ReactivePlayer,-75793,25,0.300000,0.300000,0.300000,76,62,14,true,1,14,199
ReactivePlayer,-96522,25,0.300000,0.300000,0.300000,96,82,14,true,1,14,297
ReactivePlayer,-100235,25,0.300000,0.300000,0.300000,99,88,11,false,0,11,213
ReactivePlayer,-58500,25,0.300000,0.300000,0.300000,59,47,12,true,1,12,157
ReactivePlayer,-100318,25,0.300000,0.300000,0.300000,99,84,15,false,0,15,226
ReactivePlayer,-100214,25,0.300000,0.300000,0.300000,99,77,22,false,0,22,277
ReactivePlayer,-100278,25,0.300000,0.300000,0.300000,99,73,26,false,0,26,365
ReactivePlayer,-45314,25,0.300000,0.300000,0.300000,46,40,6,true,1,6,82
ReactivePlayer,-3046,25,0.300000,0.300000,0.300000,4,1,3,true,1,3,27
ReactivePlayer,-16179,25,0.300000,0.300000,0.300000,17,14,3,true,1,3,49
ReactivePlayer,-32598,25,0.300000,0.300000,0.300000,33,21,12,true,1,12,167
ReactivePlayer,-100246,25,0.300000,0.300000,0.300000,99,79,20,false,0,20,260
ReactivePlayer,-3075,25,0.300000,0.300000,0.300000,4,2,2,true,1,2,29
ReactivePlayer,-100229,25,0.300000,0.300000,0.300000,99,77,22,false,0,22,314
ReactivePlayer,-100901,25,0.300000,0.300000,0.300000,100,84,16,false,0,16,264
ReactivePlayer,-100934,25,0.300000,0.300000,0.300000,100,89,11,false,0,11,255
ReactivePlayer,-100497,25,0.300000,0.300000,0.300000,99,81,18,false,0,18,269
ReactivePlayer,-100436,25,0.300000,0.300000,0.300000,99,79,20,false,0,20,299
ReactivePlayer,-65150,25,0.300000,0.300000,0.300000,65,55,10,true,1,10,221
ReactivePlayer,-13085,25,0.300000,0.300000,0.300000,14,5,9,true,1,9,44
ReactivePlayer,-100307,25,0.300000,0.300000,0.300000,99,86,13,false,0,13,238
ReactivePlayer,-16337,25,0.300000,0.300000,0.300000,17,9,8,true,1,8,100
ReactivePlayer,-100071,25,0.300000,0.300000,0.300000,98,66,32,false,0,32,364
ReactivePlayer,-100103,25,0.300000,0.300000,0.300000,99,73,26,false,0,26,241
ReactivePlayer,-32498,25,0.300000,0.300000,0.300000,33,23,10,true,1,10,142
ReactivePlayer,-100940,25,0.300000,0.300000,0.300000,100,80,20,false,0,20,287
ReactivePlayer,-100270,25,0.300000,0.300000,0.300000,99,82,17,false,0,17,236
ReactivePlayer,-45622,25,0.300000,0.300000,0.300000,46,34,12,true,1,12,166
ReactivePlayer,-100979,25,0.300000,0.300000,0.300000,100,84,16,false,0,16,210
ReactivePlayer,-2068,25,0.300000,0.300000,0.300000,3,3,0,true,1,0,22
ReactivePlayer,-100735,25,0.300000,0.300000,0.300000,100,83,17,false,0,17,188
ReactivePlayer,-81961,25,0.300000,0.300000,0.300000,82,68,14,true,1,14,187
ReactivePlayer,-100257,25,0.300000,0.300000,0.300000,99,80,19,false,0,19,252
ReactivePlayer,-58459,25,0.300000,0.300000,0.300000,59,50,9,true,1,9,153
ReactivePlayer,-100491,25,0.300000,0.300000,0.300000,99,90,9,false,0,9,167
ReactivePlayer,-100507,25,0.300000,0.300000,0.300000,99,81,18,false,0,18,274
ReactivePlayer,-100544,25,0.300000,0.300000,0.300000,99,81,18,false,0,18,275
ReactivePlayer,-100037,25,0.300000,0.300000,0.300000,99,76,23,false,0,23,224
ReactivePlayer,-100606,25,0.300000,0.300000,0.300000,99,87,12,false,0,12,221
ReactivePlayer,-100442,25,0.300000,0.300000,0.300000,99,74,25,false,0,25,304
ReactivePlayer,-100680,25,0.300000,0.300000,0.300000,99,71,28,false,0,28,300
ReactivePlayer,-100888,25,0.300000,0.300000,0.300000,100,82,18,false,0,18,232
ReactivePlayer,-98409,25,0.300000,0.300000,0.300000,98,80,18,true,1,18,207
ReactivePlayer,-94992,25,0.300000,0.300000,0.300000,95,80,15,true,1,15,226
ReactivePlayer,-100466,25,0.300000,0.300000,0.300000,99,86,13,false,0,13,230
ReactivePlayer,-64053,25,0.300000,0.300000,0.300000,64,50,14,true,1,14,176
ReactivePlayer,-100052,25,0.300000,0.300000,0.300000,99,78,21,false,0,21,318
ReactivePlayer,-100023,25,0.300000,0.300000,0.300000,99,73,26,false,0,26,310
ReactivePlayer,-100503,25,0.300000,0.300000,0.300000,99,85,14,false,0,14,189
ReactivePlayer,-100886,25,0.300000,0.300000,0.300000,100,79,21,false,0,21,208
ReactivePlayer,-81093,25,0.300000,0.300000,0.300000,81,59,22,true,1,22,265
ReactivePlayer,-100923,25,0.300000,0.300000,0.300000,99,89,10,false,0,10,171
ReactivePlayer,-100114,25,0.300000,0.300000,0.300000,99,78,21,false,0,21,219
ReactivePlayer,-7,25,0.300000,0.300000,0.300000,1,0,1,true,1,1,7
ReactivePlayer,-100473,25,0.300000,0.300000,0.300000,99,73,26,false,0,26,327
ReactivePlayer,-100162,25,0.300000,0.300000,0.300000,99,78,21,false,0,21,175
ReactivePlayer,-100182,25,0.300000,0.300000,0.300000,99,82,17,false,0,17,258
ReactivePlayer,-65162,25,0.300000,0.300000,0.300000,65,50,15,true,1,15,166
ReactivePlayer,-100199,25,0.300000,0.300000,0.300000,99,80,19,false,0,19,203
ReactivePlayer,-100841,25,0.300000,0.300000,0.300000,100,84,16,false,0,16,176
ReactivePlayer,-100136,25,0.300000,0.300000,0.300000,99,82,17,false,0,17,292
ReactivePlayer,-9097,25,0.300000,0.300000,0.300000,10,3,7,true,1,7,48
ReactivePlayer,-100155,25,0.300000,0.300000,0.300000,99,78,21,false,0,21,288
ReactivePlayer,-60686,25,0.300000,0.300000,0.300000,61,54,7,true,1,7,136
ReactivePlayer,-100721,25,0.300000,0.300000,0.300000,100,86,14,false,0,14,182
ReactivePlayer,-100183,25,0.300000,0.300000,0.300000,99,70,29,false,0,29,249
ReactivePlayer,-100017,25,0.300000,0.300000,0.300000,99,78,21,false,0,21,263
ReactivePlayer,-42418,25,0.300000,0.300000,0.300000,43,39,4,true,1,4,101
ReactivePlayer,-100444,25,0.300000,0.300000,0.300000,99,87,12,false,0,12,233
ReactivePlayer,-100890,25,0.300000,0.300000,0.300000,100,87,13,false,0,13,124
ReactivePlayer,-100151,25,0.300000,0.300000,0.300000,99,85,14,false,0,14,291
ReactivePlayer,-100362,25,0.300000,0.300000,0.300000,99,82,17,false,0,17,267
ReactivePlayer,-82152,25,0.300000,0.300000,0.300000,82,64,18,true,1,18,292
ReactivePlayer,-100209,25,0.300000,0.300000,0.300000,99,85,14,false,0,14,230
ReactivePlayer,-100662,25,0.300000,0.300000,0.300000,99,74,25,false,0,25,311
ReactivePlayer,-9085,25,0.300000,0.300000,0.300000,10,5,5,true,1,5,48
ReactivePlayer,-100337,25,0.300000,0.300000,0.300000,99,89,10,false,0,10,163
ReactivePlayer,-80295,25,0.300000,0.300000,0.300000,79,65,14,true,1,14,351
ReactivePlayer,-100947,25,0.300000,0.300000,0.300000,100,97,3,false,0,3,72
ReactivePlayer,-100299,25,0.300000,0.300000,0.300000,99,88,11,false,0,11,226
ReactivePlayer,-100592,25,0.300000,0.300000,0.300000,99,73,26,false,0,26,363
ReactivePlayer,-100975,25,0.300000,0.300000,0.300000,100,86,14,false,0,14,179
ReactivePlayer,-19356,25,0.300000,0.300000,0.300000,20,12,8,true,1,8,101
ReactivePlayer,-100991,25,0.300000,0.300000,0.300000,100,92,8,false,0,8,98
ReactivePlayer,-100155,25,0.300000,0.300000,0.300000,99,95,4,false,0,4,150
ReactivePlayer,-100737,25,0.300000,0.300000,0.300000,99,84,15,false,0,15,316
ReactivePlayer,-100757,25,0.300000,0.300000,0.300000,100,87,13,false,0,13,174
ReactivePlayer,-100392,25,0.300000,0.300000,0.300000,99,75,24,false,0,24,236
ReactivePlayer,-32560,25,0.300000,0.300000,0.300000,33,21,12,true,1,12,143
ReactivePlayer,-100134,25,0.300000,0.300000,0.300000,99,76,23,false,0,23,238
ReactivePlayer,-15268,25,0.300000,0.300000,0.300000,16,9,7,true,1,7,79
ReactivePlayer,-100280,25,0.300000,0.300000,0.300000,99,85,14,false,0,14,255
ReactivePlayer,-100872,25,0.300000,0.300000,0.300000,100,88,12,false,0,12,257
ReactivePlayer,-94394,25,0.300000,0.300000,0.300000,94,64,30,true,1,30,350
ReactivePlayer,-86897,25,0.300000,0.300000,0.300000,87,68,19,true,1,19,242
ReactivePlayer,-65592,25,0.300000,0.300000,0.300000,66,44,22,true,1,22,241
ReactivePlayer,-100453,25,0.300000,0.300000,0.300000,99,79,20,false,0,20,177
ReactivePlayer,-100958,25,0.300000,0.300000,0.300000,100,91,9,false,0,9,213
ReactivePlayer,-100018,25,0.300000,0.300000,0.300000,99,87,12,false,0,12,242
ReactivePlayer,-56201,25,0.300000,0.300000,0.300000,56,43,13,true,1,13,189
ReactivePlayer,-100954,25,0.300000,0.300000,0.300000,100,77,23,false,0,23,255
ReactivePlayer,-100889,25,0.300000,0.300000,0.300000,100,89,11,false,0,11,174
ReactivePlayer,-100262,25,0.300000,0.300000,0.300000,99,82,17,false,0,17,254
ReactivePlayer,-13145,25,0.300000,0.300000,0.300000,14,7,7,true,1,7,79
ReactivePlayer,-89371,25,0.300000,0.300000,0.300000,89,73,16,true,1,16,236
ReactivePlayer,-59495,25,0.300000,0.300000,0.300000,60,53,7,true,1,7,129
ReactivePlayer,-100875,25,0.300000,0.300000,0.300000,100,87,13,false,0,13,170
ReactivePlayer,-100341,25,0.300000,0.300000,0.300000,99,84,15,false,0,15,245
ReactivePlayer,-100377,25,0.300000,0.300000,0.300000,99,84,15,false,0,15,207
ReactivePlayer,-100563,25,0.300000,0.300000,0.300000,100,96,4,false,0,4,86
ReactivePlayer,-13101,25,0.300000,0.300000,0.300000,14,11,3,true,1,3,38
ReactivePlayer,-100972,25,0.300000,0.300000,0.300000,100,81,19,false,0,19,266
ReactivePlayer,-38345,25,0.300000,0.300000,0.300000,39,30,9,true,1,9,95
ReactivePlayer,-100565,25,0.300000,0.300000,0.300000,99,67,32,false,0,32,372
ReactivePlayer,-100314,25,0.300000,0.300000,0.300000,99,79,20,false,0,20,260
ReactivePlayer,-100592,25,0.300000,0.300000,0.300000,99,82,17,false,0,17,227
ReactivePlayer,-100957,25,0.300000,0.300000,0.300000,99,84,15,false,0,15,197
ReactivePlayer,-81110,25,0.300000,0.300000,0.300000,81,68,13,true,1,13,170
ReactivePlayer,-100675,25,0.300000,0.300000,0.300000,99,82,17,false,0,17,253
ReactivePlayer,-100100,25,0.300000,0.300000,0.300000,99,90,9,false,0,9,128
ReactivePlayer,-100126,25,0.300000,0.300000,0.300000,99,89,10,false,0,10,191
ReactivePlayer,-100558,25,0.300000,0.300000,0.300000,99,67,32,false,0,32,387
ReactivePlayer,-100586,25,0.300000,0.300000,0.300000,100,95,5,false,0,5,103
ReactivePlayer,-100121,25,0.300000,0.300000,0.300000,99,84,15,false,0,15,200
ReactivePlayer,-100700,25,0.300000,0.300000,0.300000,100,77,23,false,0,23,218
ReactivePlayer,-100087,25,0.300000,0.300000,0.300000,99,88,11,false,0,11,222
ReactivePlayer,-100058,25,0.300000,0.300000,0.300000,99,84,15,false,0,15,199
ReactivePlayer,-100165,25,0.300000,0.300000,0.300000,99,85,14,false,0,14,219
ReactivePlayer,-4096,25,0.300000,0.300000,0.300000,5,2,3,true,1,3,36
ReactivePlayer,-100357,25,0.300000,0.300000,0.300000,99,79,20,false,0,20,338
ReactivePlayer,-100936,25,0.300000,0.300000,0.300000,100,90,10,false,0,10,180
ReactivePlayer,-100279,25,0.300000,0.300000,0.300000,99,77,22,false,0,22,317
ReactivePlayer,-100359,25,0.300000,0.300000,0.300000,99,67,32,false,0,32,321
ReactivePlayer,-100257,25,0.300000,0.300000,0.300000,99,87,12,false,0,12,158
ReactivePlayer,-100982,25,0.300000,0.300000,0.300000,100,85,15,false,0,15,198
ReactivePlayer,-10081,25,0.300000,0.300000,0.300000,11,8,3,true,1,3,41
ReactivePlayer,-41507,25,0.300000,0.300000,0.300000,42,22,20,true,1,20,172
ReactivePlayer,-100179,25,0.300000,0.300000,0.300000,99,82,17,false,0,17,252
ReactivePlayer,-13140,25,0.300000,0.300000,0.300000,14,12,2,true,1,2,82
ReactivePlayer,-100167,25,0.300000,0.300000,0.300000,99,81,18,false,0,18,232
ReactivePlayer,-100098,25,0.300000,0.300000,0.300000,99,84,15,false,0,15,271
ReactivePlayer,-6056,25,0.300000,0.300000,0.300000,7,5,2,true,1,2,34
ReactivePlayer,-16138,25,0.300000,0.300000,0.300000,17,12,5,true,1,5,39
ReactivePlayer,-50470,25,0.300000,0.300000,0.300000,51,44,7,true,1,7,109
ReactivePlayer,-68406,25,0.300000,0.300000,0.300000,68,52,16,true,1,16,294
ReactivePlayer,-97903,25,0.300000,0.300000,0.300000,98,81,17,true,1,17,198
ReactivePlayer,-100067,25,0.300000,0.300000,0.300000,99,78,21,false,0,21,203
ReactivePlayer,-100753,25,0.300000,0.300000,0.300000,100,85,15,false,0,15,200
ReactivePlayer,-100459,25,0.300000,0.300000,0.300000,99,76,23,false,0,23,319
ReactivePlayer,-36668,25,0.300000,0.300000,0.300000,37,27,10,true,1,10,188
ReactivePlayer,-100310,25,0.300000,0.300000,0.300000,99,81,18,false,0,18,254
ReactivePlayer,-100599,25,0.300000,0.300000,0.300000,99,89,10,false,0,10,169
ReactivePlayer,-100093,25,0.300000,0.300000,0.300000,99,81,18,false,0,18,221
ReactivePlayer,-100816,25,0.300000,0.300000,0.300000,100,89,11,false,0,11,225
ReactivePlayer,-100027,25,0.300000,0.300000,0.300000,99,78,21,false,0,21,305
ReactivePlayer,-100548,25,0.300000,0.300000,0.300000,99,79,20,false,0,20,205
ReactivePlayer,-100421,25,0.300000,0.300000,0.300000,99,77,22,false,0,22,280
ReactivePlayer,-100182,25,0.300000,0.300000,0.300000,99,73,26,false,0,26,335
ReactivePlayer,-100272,25,0.300000,0.300000,0.300000,99,78,21,false,0,21,267
ReactivePlayer,-100589,25,0.300000,0.300000,0.300000,99,93,6,false,0,6,108
ReactivePlayer,-44667,25,0.300000,0.300000,0.300000,45,33,12,true,1,12,145
ReactivePlayer,-9155,25,0.300000,0.300000,0.300000,10,3,7,true,1,7,47
ReactivePlayer,-100000,25,0.300000,0.300000,0.300000,99,85,14,false,0,14,200
ReactivePlayer,-100284,25,0.300000,0.300000,0.300000,99,75,24,false,0,24,349
ReactivePlayer,-5051,25,0.300000,0.300000,0.300000,6,5,1,true,1,1,33
ReactivePlayer,-100916,25,0.300000,0.300000,0.300000,100,94,6,false,0,6,141
ReactivePlayer,-100035,25,0.300000,0.300000,0.300000,99,83,16,false,0,16,158
ReactivePlayer,-100752,25,0.300000,0.300000,0.300000,99,84,15,false,0,15,208
ReactivePlayer,-90672,25,0.300000,0.300000,0.300000,91,80,11,true,1,11,157
ReactivePlayer,-100116,25,0.300000,0.300000,0.300000,99,79,20,false,0,20,242
ReactivePlayer,-100696,25,0.300000,0.300000,0.300000,99,80,19,false,0,19,329
ReactivePlayer,-15164,25,0.300000,0.300000,0.300000,16,9,7,true,1,7,74
ReactivePlayer,-100841,25,0.300000,0.300000,0.300000,99,72,27,false,0,27,291
ReactivePlayer,-100433,25,0.300000,0.300000,0.300000,99,78,21,false,0,21,234
ReactivePlayer,-100146,25,0.300000,0.300000,0.300000,99,84,15,false,0,15,207
ReactivePlayer,-100989,25,0.300000,0.300000,0.300000,100,81,19,false,0,19,231
ReactivePlayer,-100203,25,0.300000,0.300000,0.300000,99,74,25,false,0,25,232
ReactivePlayer,-100003,25,0.300000,0.300000,0.300000,99,83,16,false,0,16,168
ReactivePlayer,-100198,25,0.300000,0.300000,0.300000,99,91,8,false,0,8,192
ReactivePlayer,-11194,25,0.300000,0.300000,0.300000,12,10,2,true,1,2,62
ReactivePlayer,-100001,25,0.300000,0.300000,0.300000,99,83,16,false,0,16,196
ReactivePlayer,-100771,25,0.300000,0.300000,0.300000,100,91,9,false,0,9,162
ReactivePlayer,-100074,25,0.300000,0.300000,0.300000,99,83,16,false,0,16,255
ReactivePlayer,-100992,25,0.300000,0.300000,0.300000,100,89,11,false,0,11,199
ReactivePlayer,-28497,25,0.300000,0.300000,0.300000,29,12,17,true,1,17,176
ReactivePlayer,-6122,25,0.300000,0.300000,0.300000,7,5,2,true,1,2,53
ReactivePlayer,-100629,25,0.300000,0.300000,0.300000,100,93,7,false,0,7,98
ReactivePlayer,-100139,25,0.300000,0.300000,0.300000,99,89,10,false,0,10,95
ReactivePlayer,-100055,25,0.300000,0.300000,0.300000,99,75,24,false,0,24,293
ReactivePlayer,-29310,25,0.300000,0.300000,0.300000,30,25,5,true,1,5,92
ReactivePlayer,-100000,25,0.300000,0.300000,0.300000,99,91,8,false,0,8,137
ReactivePlayer,-100912,25,0.300000,0.300000,0.300000,100,86,14,false,0,14,184
ReactivePlayer,1000,25,0.300000,0.300000,0.300000,0,0,0,true,1,0,0
ReactivePlayer,-77642,25,0.300000,0.300000,0.300000,78,65,13,true,1,13,122
ReactivePlayer,-100725,25,0.300000,0.300000,0.300000,99,80,19,false,0,19,292
ReactivePlayer,-100671,25,0.300000,0.300000,0.300000,100,83,17,false,0,17,170
ReactivePlayer,-93608,25,0.300000,0.300000,0.300000,93,70,23,true,1,23,324
ReactivePlayer,-87011,25,0.300000,0.300000,0.300000,87,74,13,true,1,13,186
ReactivePlayer,-39690,25,0.300000,0.300000,0.300000,40,26,14,true,1,14,192
ReactivePlayer,-100883,25,0.300000,0.300000,0.300000,100,71,29,false,0,29,208
ReactivePlayer,-100153,25,0.300000,0.300000,0.300000,99,73,26,false,0,26,350
ReactivePlayer,-100192,25,0.300000,0.300000,0.300000,99,78,21,false,0,21,268
ReactivePlayer,-100634,25,0.300000,0.300000,0.300000,99,86,13,false,0,13,300
ReactivePlayer,-62553,25,0.300000,0.300000,0.300000,63,54,9,true,1,9,111
ReactivePlayer,-100482,25,0.300000,0.300000,0.300000,99,80,19,false,0,19,306
ReactivePlayer,-100415,25,0.300000,0.300000,0.300000,99,81,18,false,0,18,292
ReactivePlayer,-100045,25,0.300000,0.300000,0.300000,99,81,18,false,0,18,212
ReactivePlayer,-37415,25,0.300000,0.300000,0.300000,38,28,10,true,1,10,116
ReactivePlayer,-100076,25,0.300000,0.300000,0.300000,99,74,25,false,0,25,314
ReactivePlayer,-60762,25,0.300000,0.300000,0.300000,61,53,8,true,1,8,119
ReactivePlayer,-100826,25,0.300000,0.300000,0.300000,100,88,12,false,0,12,160
ReactivePlayer,-22355,25,0.300000,0.300000,0.300000,23,15,8,true,1,8,108
ReactivePlayer,-100470,25,0.300000,0.300000,0.300000,99,83,16,false,0,16,344
ReactivePlayer,-100631,25,0.300000,0.300000,0.300000,99,81,18,false,0,18,273
ReactivePlayer,-100796,25,0.300000,0.300000,0.300000,100,82,18,false,0,18,216
ReactivePlayer,-100201,25,0.300000,0.300000,0.300000,99,77,22,false,0,22,229
ReactivePlayer,-100078,25,0.300000,0.300000,0.300000,99,79,20,false,0,20,283
ReactivePlayer,-49565,25,0.300000,0.300000,0.300000,50,42,8,true,1,8,114
ReactivePlayer,-100435,25,0.300000,0.300000,0.300000,99,78,21,false,0,21,319
ReactivePlayer,-15182,25,0.300000,0.300000,0.300000,16,11,5,true,1,5,108
ReactivePlayer,-100389,25,0.300000,0.300000,0.300000,99,86,13,false,0,13,196
ReactivePlayer,-100682,25,0.300000,0.300000,0.300000,99,85,14,false,0,14,202
ReactivePlayer,-67748,25,0.300000,0.300000,0.300000,68,50,18,true,1,18,173
ReactivePlayer,-100268,25,0.300000,0.300000,0.300000,99,83,16,false,0,16,189
ReactivePlayer,-100853,25,0.300000,0.300000,0.300000,100,85,15,false,0,15,192
ReactivePlayer,-100662,25,0.300000,0.300000,0.300000,99,68,31,false,0,31,375
ReactivePlayer,-100020,25,0.300000,0.300000,0.300000,99,87,12,false,0,12,132
ReactivePlayer,-33427,25,0.300000,0.300000,0.300000,34,26,8,true,1,8,131
ReactivePlayer,-100702,25,0.300000,0.300000,0.300000,100,86,14,false,0,14,161
ReactivePlayer,-59562,25,0.300000,0.300000,0.300000,60,48,12,true,1,12,169
ReactivePlayer,-20273,25,0.300000,0.300000,0.300000,21,14,7,true,1,7,96
ReactivePlayer,-100842,25,0.300000,0.300000,0.300000,100,88,12,false,0,12,215
ReactivePlayer,-100990,25,0.300000,0.300000,0.300000,100,81,19,false,0,19,199
ReactivePlayer,-100447,25,0.300000,0.300000,0.300000,99,77,22,false,0,22,302
ReactivePlayer,-100243,25,0.300000,0.300000,0.300000,99,79,20,false,0,20,267
ReactivePlayer,-100544,25,0.300000,0.300000,0.300000,99,73,26,false,0,26,279
ReactivePlayer,-100069,25,0.300000,0.300000,0.300000,99,73,26,false,0,26,221
ReactivePlayer,-100071,25,0.300000,0.300000,0.300000,99,76,23,false,0,23,315
ReactivePlayer,-100852,25,0.300000,0.300000,0.300000,99,80,19,false,0,19,302
ReactivePlayer,-100060,25,0.300000,0.300000,0.300000,99,86,13,false,0,13,202
ReactivePlayer,-100915,25,0.300000,0.300000,0.300000,100,85,15,false,0,15,175
ReactivePlayer,-100013,25,0.300000,0.300000,0.300000,99,67,32,false,0,32,280
ReactivePlayer,-100922,25,0.300000,0.300000,0.300000,100,95,5,false,0,5,110
ReactivePlayer,-100526,25,0.300000,0.300000,0.300000,100,80,20,false,0,20,164
ReactivePlayer,-24306,25,0.300000,0.300000,0.300000,25,21,4,true,1,4,56
ReactivePlayer,-100967,25,0.300000,0.300000,0.300000,100,77,23,false,0,23,291
ReactivePlayer,-44601,25,0.300000,0.300000,0.300000,45,38,7,true,1,7,130
ReactivePlayer,-100985,25,0.300000,0.300000,0.300000,100,88,12,false,0,12,272
ReactivePlayer,-44532,25,0.300000,0.300000,0.300000,45,28,17,true,1,17,187
ReactivePlayer,-100979,25,0.300000,0.300000,0.300000,100,93,7,false,0,7,159
ReactivePlayer,-37526,25,0.300000,0.300000,0.300000,38,31,7,true,1,7,88
ReactivePlayer,-44778,25,0.300000,0.300000,0.300000,45,34,11,true,1,11,194
ReactivePlayer,-33595,25,0.300000,0.300000,0.300000,34,24,10,true,1,10,124
ReactivePlayer,-100475,25,0.300000,0.300000,0.300000,99,86,13,false,0,13,248
ReactivePlayer,-100650,25,0.300000,0.300000,0.300000,99,84,15,false,0,15,191
ReactivePlayer,-46247,25,0.300000,0.300000,0.300000,47,38,9,true,1,9,88
ReactivePlayer,-100405,25,0.300000,0.300000,0.300000,99,71,28,false,0,28,311
ReactivePlayer,-100051,25,0.300000,0.300000,0.300000,99,78,21,false,0,21,232
ReactivePlayer,-100958,25,0.300000,0.300000,0.300000,100,81,19,false,0,19,223
ReactivePlayer,-25185,25,0.300000,0.300000,0.300000,26,17,9,true,1,9,71
ReactivePlayer,-100684,25,0.300000,0.300000,0.300000,100,86,14,false,0,14,237
ReactivePlayer,-100338,25,0.300000,0.300000,0.300000,99,78,21,false,0,21,270
ReactivePlayer,-100431,25,0.300000,0.300000,0.300000,99,68,31,false,0,31,287
ReactivePlayer,-82712,25,0.300000,0.300000,0.300000,82,65,17,true,1,17,187
ReactivePlayer,-100418,25,0.300000,0.300000,0.300000,99,73,26,false,0,26,306
ReactivePlayer,-100098,25,0.300000,0.300000,0.300000,99,77,22,false,0,22,234
ReactivePlayer,-4091,25,0.300000,0.300000,0.300000,5,2,3,true,1,3,37
ReactivePlayer,-100830,25,0.300000,0.300000,0.300000,100,91,9,false,0,9,129
ReactivePlayer,-100835,25,0.300000,0.300000,0.300000,100,86,14,false,0,14,188
ReactivePlayer,-100079,25,0.300000,0.300000,0.300000,99,90,9,false,0,9,224
ReactivePlayer,-100090,25,0.300000,0.300000,0.300000,99,78,21,false,0,21,214
ReactivePlayer,-3093,25,0.300000,0.300000,0.300000,4,1,3,true,1,3,31
ReactivePlayer,-70594,25,0.300000,0.300000,0.300000,71,60,11,true,1,11,102
ReactivePlayer,-100237,25,0.300000,0.300000,0.300000,99,83,16,false,0,16,297
ReactivePlayer,-100432,25,0.300000,0.300000,0.300000,99,79,20,false,0,20,284
ReactivePlayer,-24324,25,0.300000,0.300000,0.300000,25,15,10,true,1,10,137
ReactivePlayer,-100523,25,0.300000,0.300000,0.300000,100,93,7,false,0,7,93
ReactivePlayer,-100378,25,0.300000,0.300000,0.300000,99,76,23,false,0,23,291
ReactivePlayer,-100059,25,0.300000,0.300000,0.300000,99,90,9,false,0,9,174
ReactivePlayer,-61552,25,0.300000,0.300000,0.300000,62,49,13,true,1,13,155
ReactivePlayer,-100334,25,0.300000,0.300000,0.300000,99,66,33,false,0,33,297
ReactivePlayer,-100036,25,0.300000,0.300000,0.300000,99,72,27,false,0,27,271
ReactivePlayer,-100498,25,0.300000,0.300000,0.300000,100,94,6,false,0,6,94
ReactivePlayer,-100769,25,0.300000,0.300000,0.300000,100,93,7,false,0,7,71
ReactivePlayer,-100733,25,0.300000,0.300000,0.300000,100,83,17,false,0,17,230
ReactivePlayer,-100763,25,0.300000,0.300000,0.300000,100,84,16,false,0,16,181
ReactivePlayer,-100392,25,0.300000,0.300000,0.300000,99,89,10,false,0,10,186
ReactivePlayer,-100324,25,0.300000,0.300000,0.300000,99,88,11,false,0,11,211
ReactivePlayer,-100226,25,0.300000,0.300000,0.300000,99,82,17,false,0,17,210
ReactivePlayer,-100473,25,0.300000,0.300000,0.300000,99,77,22,false,0,22,285
ReactivePlayer,-35458,25,0.300000,0.300000,0.300000,36,26,10,true,1,10,143
ReactivePlayer,1000,25,0.300000,0.300000,0.300000,0,0,0,true,1,0,0
ReactivePlayer,-66871,25,0.300000,0.300000,0.300000,67,48,19,true,1,19,199
ReactivePlayer,-100031,25,0.300000,0.300000,0.300000,98,75,23,false,0,23,293
ReactivePlayer,-55371,25,0.300000,0.300000,0.300000,56,52,4,true,1,4,129
ReactivePlayer,-100846,25,0.300000,0.300000,0.300000,99,79,20,false,0,20,374
ReactivePlayer,-100912,25,0.300000,0.300000,0.300000,100,85,15,false,0,15,173
ReactivePlayer,-1038,25,0.300000,0.300000,0.300000,2,1,1,true,1,1,20
ReactivePlayer,-45374,25,0.300000,0.300000,0.300000,46,39,7,true,1,7,117
ReactivePlayer,-100835,25,0.300000,0.300000,0.300000,100,79,21,false,0,21,202
ReactivePlayer,-100225,25,0.300000,0.300000,0.300000,99,68,31,false,0,31,360
ReactivePlayer,-100041,25,0.300000,0.300000,0.300000,99,86,13,false,0,13,204
ReactivePlayer,-55761,25,0.300000,0.300000,0.300000,56,42,14,true,1,14,222
ReactivePlayer,-100000,25,0.300000,0.300000,0.300000,99,75,24,false,0,24,282
ReactivePlayer,-100873,25,0.300000,0.300000,0.300000,100,78,22,false,0,22,226
ReactivePlayer,999,25,0.300000,0.300000,0.300000,0,0,0,true,1,0,1
ReactivePlayer,-100320,25,0.300000,0.300000,0.300000,99,83,16,false,0,16,259
ReactivePlayer,-100476,25,0.300000,0.300000,0.300000,99,79,20,false,0,20,275
ReactivePlayer,-75836,25,0.300000,0.300000,0.300000,76,53,23,true,1,23,218
ReactivePlayer,-100203,25,0.300000,0.300000,0.300000,99,78,21,false,0,21,246
ReactivePlayer,-100089,25,0.300000,0.300000,0.300000,99,91,8,false,0,8,238
ReactivePlayer,-61710,25,0.300000,0.300000,0.300000,62,52,10,true,1,10,155
ReactivePlayer,-100444,25,0.300000,0.300000,0.300000,99,77,22,false,0,22,279
ReactivePlayer,-100961,25,0.300000,0.300000,0.300000,100,81,19,false,0,19,275
ReactivePlayer,-67611,25,0.300000,0.300000,0.300000,68,59,9,true,1,9,147
ReactivePlayer,-100677,25,0.300000,0.300000,0.300000,100,88,12,false,0,12,219
ReactivePlayer,-100912,25,0.300000,0.300000,0.300000,100,88,12,false,0,12,209
ReactivePlayer,-83690,25,0.300000,0.300000,0.300000,84,73,11,true,1,11,194
ReactivePlayer,-100058,25,0.300000,0.300000,0.300000,99,85,14,false,0,14,197
ReactivePlayer,-15541,25,0.300000,0.300000,0.300000,16,9,7,true,1,7,108
ReactivePlayer,-61875,25,0.300000,0.300000,0.300000,62,49,13,true,1,13,230
ReactivePlayer,-100123,25,0.300000,0.300000,0.300000,99,82,17,false,0,17,231
ReactivePlayer,-100054,25,0.300000,0.300000,0.300000,99,75,24,false,0,24,320
ReactivePlayer,-100181,25,0.300000,0.300000,0.300000,99,85,14,false,0,14,234
ReactivePlayer,-30405,25,0.300000,0.300000,0.300000,31,24,7,true,1,7,133
ReactivePlayer,-35317,25,0.300000,0.300000,0.300000,36,30,6,true,1,6,111
ReactivePlayer,-100236,25,0.300000,0.300000,0.300000,99,77,22,false,0,22,247
ReactivePlayer,-100330,25,0.300000,0.300000,0.300000,99,76,23,false,0,23,326
ReactivePlayer,-100200,25,0.300000,0.300000,0.300000,99,84,15,false,0,15,216
ReactivePlayer,-19196,25,0.300000,0.300000,0.300000,20,13,7,true,1,7,69
ReactivePlayer,-100091,25,0.300000,0.300000,0.300000,99,75,24,false,0,24,273
ReactivePlayer,-100532,25,0.300000,0.300000,0.300000,99,83,16,false,0,16,297
ReactivePlayer,-12138,25,0.300000,0.300000,0.300000,13,6,7,true,1,7,76
ReactivePlayer,-100148,25,0.300000,0.300000,0.300000,99,75,24,false,0,24,318
ReactivePlayer,-100042,25,0.300000,0.300000,0.300000,99,80,19,false,0,19,307
ReactivePlayer,-88928,25,0.300000,0.300000,0.300000,89,70,19,true,1,19,203
ReactivePlayer,-100187,25,0.300000,0.300000,0.300000,99,74,25,false,0,25,260
ReactivePlayer,-100286,25,0.300000,0.300000,0.300000,99,82,17,false,0,17,303
ReactivePlayer,-100703,25,0.300000,0.300000,0.300000,99,76,23,false,0,23,290
ReactivePlayer,-64056,25,0.300000,0.300000,0.300000,64,43,21,true,1,21,177
ReactivePlayer,-4152,25,0.300000,0.300000,0.300000,5,3,2,true,1,2,29
ReactivePlayer,-100127,25,0.300000,0.300000,0.300000,99,78,21,false,0,21,298
ReactivePlayer,-100226,25,0.300000,0.300000,0.300000,99,75,24,false,0,24,260
ReactivePlayer,-100572,25,0.300000,0.300000,0.300000,100,91,9,false,0,9,86
ReactivePlayer,-100244,25,0.300000,0.300000,0.300000,99,89,10,false,0,10,231
ReactivePlayer,-65656,25,0.300000,0.300000,0.300000,66,48,18,true,1,18,164
ReactivePlayer,-75811,25,0.300000,0.300000,0.300000,76,61,15,true,1,15,257
ReactivePlayer,-100675,25,0.300000,0.300000,0.300000,99,67,32,false,0,32,404
ReactivePlayer,-65506,25,0.300000,0.300000,0.300000,66,52,14,true,1,14,149
ReactivePlayer,-19437,25,0.300000,0.300000,0.300000,20,16,4,true,1,4,83
ReactivePlayer,-100622,25,0.300000,0.300000,0.300000,99,73,26,false,0,26,318
ReactivePlayer,-100912,25,0.300000,0.300000,0.300000,100,80,20,false,0,20,211
ReactivePlayer,-100181,25,0.300000,0.300000,0.300000,99,80,19,false,0,19,292
ReactivePlayer,-17287,25,0.300000,0.300000,0.300000,18,10,8,true,1,8,92
ReactivePlayer,-100923,25,0.300000,0.300000,0.300000,100,86,14,false,0,14,178
ReactivePlayer,-100346,25,0.300000,0.300000,0.300000,99,85,14,false,0,14,224
ReactivePlayer,-100507,25,0.300000,0.300000,0.300000,99,80,19,false,0,19,241
ReactivePlayer,-100314,25,0.300000,0.300000,0.300000,99,90,9,false,0,9,225
ReactivePlayer,-100276,25,0.300000,0.300000,0.300000,99,84,15,false,0,15,196
ReactivePlayer,-37364,25,0.300000,0.300000,0.300000,38,31,7,true,1,7,108
ReactivePlayer,-100708,25,0.300000,0.300000,0.300000,99,85,14,false,0,14,277
ReactivePlayer,-100756,25,0.300000,0.300000,0.300000,100,90,10,false,0,10,154
ReactivePlayer,-28389,25,0.300000,0.300000,0.300000,29,21,8,true,1,8,121
ReactivePlayer,-100301,25,0.300000,0.300000,0.300000,99,75,24,false,0,24,279
ReactivePlayer,-71652,25,0.300000,0.300000,0.300000,72,64,8,true,1,8,120
ReactivePlayer,-100092,25,0.300000,0.300000,0.300000,99,89,10,false,0,10,159
ReactivePlayer,-100908,25,0.300000,0.300000,0.300000,99,86,13,false,0,13,257
ReactivePlayer,-100340,25,0.300000,0.300000,0.300000,99,89,10,false,0,10,203
ReactivePlayer,-100079,25,0.300000,0.300000,0.300000,99,87,12,false,0,12,238
ReactivePlayer,-100100,25,0.300000,0.300000,0.300000,99,82,17,false,0,17,203
ReactivePlayer,-21175,25,0.300000,0.300000,0.300000,22,17,5,true,1,5,97
ReactivePlayer,-100920,25,0.300000,0.300000,0.300000,100,79,21,false,0,21,258
ReactivePlayer,-50550,25,0.300000,0.300000,0.300000,51,42,9,true,1,9,171
ReactivePlayer,-100725,25,0.300000,0.300000,0.300000,99,72,27,false,0,27,243
ReactivePlayer,-25329,25,0.300000,0.300000,0.300000,26,14,12,true,1,12,118
ReactivePlayer,-100678,25,0.300000,0.300000,0.300000,99,73,26,false,0,26,314
ReactivePlayer,-100463,25,0.300000,0.300000,0.300000,99,78,21,false,0,21,294
ReactivePlayer,-100208,25,0.300000,0.300000,0.300000,99,76,23,false,0,23,189
ReactivePlayer,-100330,25,0.300000,0.300000,0.300000,99,80,19,false,0,19,311
ReactivePlayer,-100368,25,0.300000,0.300000,0.300000,99,72,27,false,0,27,340
ReactivePlayer,-100000,25,0.300000,0.300000,0.300000,99,71,28,false,0,28,269
ReactivePlayer,-100747,25,0.300000,0.300000,0.300000,100,89,11,false,0,11,153
ReactivePlayer,-100034,25,0.300000,0.300000,0.300000,99,88,11,false,0,11,211
ReactivePlayer,-12214,25,0.300000,0.300000,0.300000,13,9,4,true,1,4,77
ReactivePlayer,-8118,25,0.300000,0.300000,0.300000,9,6,3,true,1,3,40
ReactivePlayer,-100480,25,0.300000,0.300000,0.300000,99,78,21,false,0,21,256
ReactivePlayer,-2023,25,0.300000,0.300000,0.300000,3,0,3,true,1,3,16
ReactivePlayer,-33573,25,0.300000,0.300000,0.300000,34,24,10,true,1,10,158
ReactivePlayer,-89260,25,0.300000,0.300000,0.300000,89,71,18,true,1,18,285
ReactivePlayer,-100837,25,0.300000,0.300000,0.300000,100,96,4,false,0,4,121
ReactivePlayer,-101000,25,0.300000,0.300000,0.300000,100,88,12,false,0,12,160
ReactivePlayer,-100097,25,0.300000,0.300000,0.300000,99,82,17,false,0,17,268
ReactivePlayer,-100142,25,0.300000,0.300000,0.300000,98,67,31,false,0,31,388
ReactivePlayer,-100237,25,0.300000,0.300000,0.300000,99,81,18,false,0,18,224
ReactivePlayer,-70148,25,0.300000,0.300000,0.300000,70,57,13,true,1,13,205
ReactivePlayer,-100511,25,0.300000,0.300000,0.300000,99,92,7,false,0,7,94
ReactivePlayer,-16358,25,0.300000,0.300000,0.300000,17,12,5,true,1,5,128
ReactivePlayer,-100217,25,0.300000,0.300000,0.300000,99,78,21,false,0,21,279
ReactivePlayer,-100000,25,0.300000,0.300000,0.300000,99,87,12,false,0,12,165
ReactivePlayer,-100387,25,0.300000,0.300000,0.300000,99,78,21,false,0,21,191
ReactivePlayer,-42593,25,0.300000,0.300000,0.300000,43,35,8,true,1,8,142
ReactivePlayer,-1065,25,0.300000,0.300000,0.300000,2,1,1,true,1,1,25
ReactivePlayer,-50559,25,0.300000,0.300000,0.300000,51,41,10,true,1,10,141
ReactivePlayer,-100219,25,0.300000,0.300000,0.300000,98,79,19,false,0,19,282
ReactivePlayer,-100872,25,0.300000,0.300000,0.300000,99,86,13,false,0,13,241
ReactivePlayer,-100252,25,0.300000,0.300000,0.300000,99,78,21,false,0,21,276
ReactivePlayer,-100752,25,0.300000,0.300000,0.300000,100,85,15,false,0,15,250
ReactivePlayer,-100519,25,0.300000,0.300000,0.300000,99,84,15,false,0,15,233
ReactivePlayer,-81814,25,0.300000,0.300000,0.300000,82,70,12,true,1,12,216
ReactivePlayer,-100266,25,0.300000,0.300000,0.300000,99,90,9,false,0,9,165
ReactivePlayer,-100978,25,0.300000,0.300000,0.300000,100,84,16,false,0,16,199
ReactivePlayer,-88135,25,0.300000,0.300000,0.300000,88,69,19,true,1,19,222
ReactivePlayer,-100000,25,0.300000,0.300000,0.300000,99,79,20,false,0,20,313
ReactivePlayer,-91828,25,0.300000,0.300000,0.300000,92,71,21,true,1,21,236
ReactivePlayer,-100269,25,0.300000,0.300000,0.300000,99,75,24,false,0,24,276
ReactivePlayer,-70693,25,0.300000,0.300000,0.300000,71,56,15,true,1,15,209
ReactivePlayer,-100792,25,0.300000,0.300000,0.300000,100,86,14,false,0,14,215
ReactivePlayer,-100146,25,0.300000,0.300000,0.300000,99,88,11,false,0,11,224
ReactivePlayer,-78709,25,0.300000,0.300000,0.300000,79,65,14,true,1,14,165
ReactivePlayer,-31285,25,0.300000,0.300000,0.300000,32,19,13,true,1,13,94
ReactivePlayer,-100068,25,0.300000,0.300000,0.300000,99,84,15,false,0,15,247
ReactivePlayer,-100128,25,0.300000,0.300000,0.300000,99,82,17,false,0,17,199
ReactivePlayer,-100097,25,0.300000,0.300000,0.300000,99,78,21,false,0,21,243
ReactivePlayer,-97140,25,0.300000,0.300000,0.300000,97,74,23,true,1,23,223
ReactivePlayer,-100088,25,0.300000,0.300000,0.300000,99,89,10,false,0,10,174
ReactivePlayer,-100874,25,0.300000,0.300000,0.300000,99,67,32,false,0,32,349
ReactivePlayer,-73942,25,0.300000,0.300000,0.300000,74,51,23,true,1,23,272
ReactivePlayer,-100697,25,0.300000,0.300000,0.300000,100,92,8,false,0,8,106
ReactivePlayer,-100980,25,0.300000,0.300000,0.300000,100,89,11,false,0,11,178
ReactivePlayer,-100180,25,0.300000,0.300000,0.300000,99,63,36,false,0,36,338
ReactivePlayer,-87408,25,0.300000,0.300000,0.300000,87,77,10,true,1,10,142
ReactivePlayer,-100631,25,0.300000,0.300000,0.300000,99,82,17,false,0,17,270
ReactivePlayer,-11387,25,0.300000,0.300000,0.300000,12,7,5,true,1,5,97
ReactivePlayer,-100452,25,0.300000,0.300000,0.300000,99,74,25,false,0,25,275
ReactivePlayer,-100206,25,0.300000,0.300000,0.300000,99,80,19,false,0,19,315
ReactivePlayer,-100972,25,0.300000,0.300000,0.300000,100,83,17,false,0,17,210
ReactivePlayer,-100176,25,0.300000,0.300000,0.300000,99,85,14,false,0,14,222
ReactivePlayer,-1065,25,0.300000,0.300000,0.300000,2,0,2,true,1,2,25
ReactivePlayer,-24320,25,0.300000,0.300000,0.300000,25,18,7,true,1,7,92
ReactivePlayer,-100479,25,0.300000,0.300000,0.300000,99,78,21,false,0,21,278
ReactivePlayer,-100115,25,0.300000,0.300000,0.300000,99,84,15,false,0,15,217
ReactivePlayer,-100977,25,0.300000,0.300000,0.300000,100,91,9,false,0,9,103
ReactivePlayer,-78660,25,0.300000,0.300000,0.300000,79,71,8,true,1,8,101
ReactivePlayer,-100790,25,0.300000,0.300000,0.300000,100,87,13,false,0,13,201
ReactivePlayer,-100065,25,0.300000,0.300000,0.300000,99,79,20,false,0,20,221
ReactivePlayer,-100461,25,0.300000,0.300000,0.300000,99,73,26,false,0,26,305
ReactivePlayer,-100762,25,0.300000,0.300000,0.300000,100,82,18,false,0,18,221
ReactivePlayer,-100987,25,0.300000,0.300000,0.300000,100,83,17,false,0,17,209
ReactivePlayer,-43715,25,0.300000,0.300000,0.300000,44,33,11,true,1,11,206
ReactivePlayer,-100793,25,0.300000,0.300000,0.300000,100,91,9,false,0,9,139
ReactivePlayer,-39541,25,0.300000,0.300000,0.300000,40,30,10,true,1,10,116
ReactivePlayer,-100651,25,0.300000,0.300000,0.300000,100,96,4,false,0,4,87
ReactivePlayer,-5200,25,0.300000,0.300000,0.300000,6,4,2,true,1,2,42
ReactivePlayer,-22291,25,0.300000,0.300000,0.300000,23,17,6,true,1,6,96
ReactivePlayer,-100111,25,0.300000,0.300000,0.300000,99,80,19,false,0,19,258
ReactivePlayer,-100185,25,0.300000,0.300000,0.300000,99,78,21,false,0,21,280
ReactivePlayer,-100409,25,0.300000,0.300000,0.300000,99,87,12,false,0,12,130
ReactivePlayer,-100412,25,0.300000,0.300000,0.300000,99,75,24,false,0,24,288
ReactivePlayer,-28314,25,0.300000,0.300000,0.300000,29,18,11,true,1,11,131
ReactivePlayer,-100062,25,0.300000,0.300000,0.300000,99,77,22,false,0,22,303
ReactivePlayer,-100018,25,0.300000,0.300000,0.300000,99,86,13,false,0,13,142
ReactivePlayer,-10126,25,0.300000,0.300000,0.300000,11,7,4,true,1,4,41
ReactivePlayer,-100235,25,0.300000,0.300000,0.300000,99,76,23,false,0,23,317
ReactivePlayer,-47967,25,0.300000,0.300000,0.300000,48,44,4,true,1,4,175
ReactivePlayer,-100875,25,0.300000,0.300000,0.300000,100,93,7,false,0,7,161
ReactivePlayer,-100565,25,0.300000,0.300000,0.300000,99,76,23,false,0,23,400
ReactivePlayer,-26393,25,0.300000,0.300000,0.300000,27,20,7,true,1,7,110
ReactivePlayer,-100127,25,0.300000,0.300000,0.300000,99,82,17,false,0,17,176
ReactivePlayer,-100434,25,0.300000,0.300000,0.300000,99,77,22,false,0,22,288
ReactivePlayer,-19214,25,0.300000,0.300000,0.300000,20,13,7,true,1,7,84
ReactivePlayer,-100114,25,0.300000,0.300000,0.300000,99,91,8,false,0,8,181
ReactivePlayer,-100594,25,0.300000,0.300000,0.300000,99,79,20,false,0,20,294
ReactivePlayer,-100546,25,0.300000,0.300000,0.300000,99,84,15,false,0,15,240
ReactivePlayer,-34344,25,0.300000,0.300000,0.300000,35,28,7,true,1,7,114
ReactivePlayer,-100364,25,0.300000,0.300000,0.300000,99,79,20,false,0,20,278
ReactivePlayer,-2,25,0.300000,0.300000,0.300000,1,1,0,true,1,0,2
ReactivePlayer,-100322,25,0.300000,0.300000,0.300000,99,86,13,false,0,13,330
ReactivePlayer,-71009,25,0.300000,0.300000,0.300000,71,51,20,true,1,20,228
ReactivePlayer,-100788,25,0.300000,0.300000,0.300000,99,75,24,false,0,24,263
ReactivePlayer,-100661,25,0.300000,0.300000,0.300000,100,85,15,false,0,15,167
ReactivePlayer,-100444,25,0.300000,0.300000,0.300000,99,81,18,false,0,18,267
ReactivePlayer,-100000,25,0.300000,0.300000,0.300000,99,81,18,false,0,18,263
ReactivePlayer,-100291,25,0.300000,0.300000,0.300000,99,86,13,false,0,13,147
ReactivePlayer,-100448,25,0.300000,0.300000,0.300000,99,59,40,false,0,40,383
ReactivePlayer,-100169,25,0.300000,0.300000,0.300000,99,88,11,false,0,11,169
ReactivePlayer,-2087,25,0.300000,0.300000,0.300000,3,0,3,true,1,3,41
ReactivePlayer,-3102,25,0.300000,0.300000,0.300000,4,0,4,true,1,4,14
ReactivePlayer,-100290,25,0.300000,0.300000,0.300000,99,86,13,false,0,13,176
ReactivePlayer,-34536,25,0.300000,0.300000,0.300000,35,26,9,true,1,9,97
ReactivePlayer,-100992,25,0.300000,0.300000,0.300000,100,84,16,false,0,16,216
ReactivePlayer,-48636,25,0.300000,0.300000,0.300000,49,37,12,true,1,12,208
ReactivePlayer,-89071,25,0.300000,0.300000,0.300000,89,73,16,true,1,16,226
ReactivePlayer,-64173,25,0.300000,0.300000,0.300000,64,54,10,true,1,10,132
ReactivePlayer,-100963,25,0.300000,0.300000,0.300000,100,72,28,false,0,28,286
ReactivePlayer,-100720,25,0.300000,0.300000,0.300000,100,83,17,false,0,17,210
ReactivePlayer,-100170,25,0.300000,0.300000,0.300000,98,75,23,false,0,23,351
ReactivePlayer,-100333,25,0.300000,0.300000,0.300000,99,79,20,false,0,20,285
ReactivePlayer,-100151,25,0.300000,0.300000,0.300000,99,78,21,false,0,21,250
ReactivePlayer,-7126,25,0.300000,0.300000,0.300000,8,4,4,true,1,4,36
ReactivePlayer,-16236,25,0.300000,0.300000,0.300000,17,13,4,true,1,4,71
ReactivePlayer,-100818,25,0.300000,0.300000,0.300000,100,80,20,false,0,20,188
ReactivePlayer,-93295,25,0.300000,0.300000,0.300000,93,66,27,true,1,27,311
ReactivePlayer,-68846,25,0.300000,0.300000,0.300000,69,52,17,true,1,17,145
ReactivePlayer,-100945,25,0.300000,0.300000,0.300000,100,74,26,false,0,26,305
ReactivePlayer,-100170,25,0.300000,0.300000,0.300000,99,79,20,false,0,20,255
ReactivePlayer,-42390,25,0.300000,0.300000,0.300000,43,36,7,true,1,7,87
ReactivePlayer,981,25,0.300000,0.300000,0.300000,0,0,0,true,1,0,12
ReactivePlayer,-100372,25,0.300000,0.300000,0.300000,99,79,20,false,0,20,267
ReactivePlayer,-60507,25,0.300000,0.300000,0.300000,61,40,21,true,1,21,215
ReactivePlayer,-100070,25,0.300000,0.300000,0.300000,99,81,18,false,0,18,201
ReactivePlayer,-100453,25,0.300000,0.300000,0.300000,100,98,2,false,0,2,48
ReactivePlayer,-100385,25,0.300000,0.300000,0.300000,99,84,15,false,0,15,247
ReactivePlayer,-8052,25,0.300000,0.300000,0.300000,9,7,2,true,1,2,25
ReactivePlayer,-52615,25,0.300000,0.300000,0.300000,53,41,12,true,1,12,158
ReactivePlayer,-100881,25,0.300000,0.300000,0.300000,100,91,9,false,0,9,183
ReactivePlayer,-100683,25,0.300000,0.300000,0.300000,99,67,32,false,0,32,320
ReactivePlayer,-100999,25,0.300000,0.300000,0.300000,100,80,20,false,0,20,281
ReactivePlayer,-11092,25,0.300000,0.300000,0.300000,12,10,2,true,1,2,45
ReactivePlayer,-100691,25,0.300000,0.300000,0.300000,100,92,8,false,0,8,166
ReactivePlayer,-100325,25,0.300000,0.300000,0.300000,99,87,12,false,0,12,276
ReactivePlayer,-50632,25,0.300000,0.300000,0.300000,51,34,17,true,1,17,203
ReactivePlayer,-100988,25,0.300000,0.300000,0.300000,100,89,11,false,0,11,212
ReactivePlayer,-65477,25,0.300000,0.300000,0.300000,65,55,10,true,1,10,210
ReactivePlayer,-100979,25,0.300000,0.300000,0.300000,100,91,9,false,0,9,161
ReactivePlayer,-74612,25,0.300000,0.300000,0.300000,75,67,8,true,1,8,136
ReactivePlayer,-53629,25,0.300000,0.300000,0.300000,54,43,11,true,1,11,159
ReactivePlayer,-42632,25,0.300000,0.300000,0.300000,43,30,13,true,1,13,159
ReactivePlayer,-100943,25,0.300000,0.300000,0.300000,100,91,9,false,0,9,139
ReactivePlayer,-100302,25,0.300000,0.300000,0.300000,99,85,14,false,0,14,313
ReactivePlayer,-27347,25,0.300000,0.300000,0.300000,28,21,7,true,1,7,71
ReactivePlayer,-100930,25,0.300000,0.300000,0.300000,100,89,11,false,0,11,219
ReactivePlayer,-100788,25,0.300000,0.300000,0.300000,100,85,15,false,0,15,223
ReactivePlayer,-100921,25,0.300000,0.300000,0.300000,100,83,17,false,0,17,222
ReactivePlayer,-100419,25,0.300000,0.300000,0.300000,99,88,11,false,0,11,264
ReactivePlayer,-100962,25,0.300000,0.300000,0.300000,100,85,15,false,0,15,253
ReactivePlayer,-100655,25,0.300000,0.300000,0.300000,100,84,16,false,0,16,233
ReactivePlayer,-100351,25,0.300000,0.300000,0.300000,99,80,19,false,0,19,249
ReactivePlayer,-100757,25,0.300000,0.300000,0.300000,100,94,6,false,0,6,80
ReactivePlayer,-100533,25,0.300000,0.300000,0.300000,100,92,8,false,0,8,100
ReactivePlayer,-100670,25,0.300000,0.300000,0.300000,100,80,20,false,0,20,175
ReactivePlayer,-100991,25,0.300000,0.300000,0.300000,100,86,14,false,0,14,208
ReactivePlayer,-91152,25,0.300000,0.300000,0.300000,91,68,23,true,1,23,278
ReactivePlayer,-34533,25,0.300000,0.300000,0.300000,35,22,13,true,1,13,159
ReactivePlayer,-100692,25,0.300000,0.300000,0.300000,100,86,14,false,0,14,219
ReactivePlayer,-12164,25,0.300000,0.300000,0.300000,13,6,7,true,1,7,88
ReactivePlayer,-71969,25,0.300000,0.300000,0.300000,72,58,14,true,1,14,224
ReactivePlayer,-100348,25,0.300000,0.300000,0.300000,99,83,16,false,0,16,211
ReactivePlayer,-100900,25,0.300000,0.300000,0.300000,100,82,18,false,0,18,207
ReactivePlayer,-100800,25,0.300000,0.300000,0.300000,100,94,6,false,0,6,92
ReactivePlayer,-100257,25,0.300000,0.300000,0.300000,99,80,19,false,0,19,234
ReactivePlayer,-100337,25,0.300000,0.300000,0.300000,99,82,17,false,0,17,234
ReactivePlayer,-100262,25,0.300000,0.300000,0.300000,99,72,27,false,0,27,330
ReactivePlayer,-100752,25,0.300000,0.300000,0.300000,100,93,7,false,0,7,171
ReactivePlayer,-22193,25,0.300000,0.300000,0.300000,23,20,3,true,1,3,64
ReactivePlayer,-13354,25,0.300000,0.300000,0.300000,14,8,6,true,1,6,91
ReactivePlayer,-100393,25,0.300000,0.300000,0.300000,99,87,12,false,0,12,248
ReactivePlayer,-78318,25,0.300000,0.300000,0.300000,78,67,11,true,1,11,179
ReactivePlayer,-8094,25,0.300000,0.300000,0.300000,9,9,0,true,1,0,32
ReactivePlayer,995,25,0.300000,0.300000,0.300000,0,0,0,true,1,0,5
ReactivePlayer,-9086,25,0.300000,0.300000,0.300000,10,3,7,true,1,7,59
ReactivePlayer,-100229,25,0.300000,0.300000,0.300000,99,70,29,false,0,29,282
ReactivePlayer,-100025,25,0.300000,0.300000,0.300000,99,90,9,false,0,9,182
ReactivePlayer,-100084,25,0.300000,0.300000,0.300000,99,85,14,false,0,14,223
ReactivePlayer,-100043,25,0.300000,0.300000,0.300000,98,79,19,false,0,19,245
ReactivePlayer,-100107,25,0.300000,0.300000,0.300000,99,81,18,false,0,18,250
ReactivePlayer,-100240,25,0.300000,0.300000,0.300000,99,77,22,false,0,22,217
ReactivePlayer,-100023,25,0.300000,0.300000,0.300000,98,75,23,false,0,23,314
ReactivePlayer,-100000,25,0.300000,0.300000,0.300000,99,82,17,false,0,17,235
ReactivePlayer,-100926,25,0.300000,0.300000,0.300000,100,83,17,false,0,17,187
ReactivePlayer,-100913,25,0.300000,0.300000,0.300000,100,76,24,false,0,24,252
ReactivePlayer,-100677,25,0.300000,0.300000,0.300000,99,77,22,false,0,22,274
ReactivePlayer,-100398,25,0.300000,0.300000,0.300000,99,88,11,false,0,11,216
ReactivePlayer,-100669,25,0.300000,0.300000,0.300000,99,89,10,false,0,10,143
ReactivePlayer,-73889,25,0.300000,0.300000,0.300000,74,62,12,true,1,12,177
ReactivePlayer,-67799,25,0.300000,0.300000,0.300000,68,55,13,true,1,13,220
ReactivePlayer,-100776,25,0.300000,0.300000,0.300000,100,85,15,false,0,15,186
ReactivePlayer,-100083,25,0.300000,0.300000,0.300000,99,79,20,false,0,20,238
ReactivePlayer,-100942,25,0.300000,0.300000,0.300000,99,82,17,false,0,17,248
ReactivePlayer,-100206,25,0.300000,0.300000,0.300000,99,80,19,false,0,19,219
ReactivePlayer,-100262,25,0.300000,0.300000,0.300000,99,77,22,false,0,22,353
ReactivePlayer,-100226,25,0.300000,0.300000,0.300000,99,82,17,false,0,17,199
ReactivePlayer,-100904,25,0.300000,0.300000,0.300000,100,86,14,false,0,14,184
ReactivePlayer,-100396,25,0.300000,0.300000,0.300000,99,76,23,false,0,23,288
ReactivePlayer,-100932,25,0.300000,0.300000,0.300000,100,88,12,false,0,12,224
ReactivePlayer,-100353,25,0.300000,0.300000,0.300000,99,70,29,false,0,29,361
ReactivePlayer,-100405,25,0.300000,0.300000,0.300000,99,82,17,false,0,17,280
ReactivePlayer,-60521,25,0.300000,0.300000,0.300000,61,49,12,true,1,12,171
ReactivePlayer,-100255,25,0.300000,0.300000,0.300000,99,77,22,false,0,22,306
ReactivePlayer,-89830,25,0.300000,0.300000,0.300000,90,73,17,true,1,17,223
ReactivePlayer,-12131,25,0.300000,0.300000,0.300000,13,4,9,true,1,9,70
ReactivePlayer,-100862,25,0.300000,0.300000,0.300000,100,83,17,false,0,17,250
ReactivePlayer,-100195,25,0.300000,0.300000,0.300000,99,78,21,false,0,21,298
ReactivePlayer,-100098,25,0.300000,0.300000,0.300000,99,78,21,false,0,21,278
ReactivePlayer,-100354,25,0.300000,0.300000,0.300000,99,86,13,false,0,13,294
ReactivePlayer,-100034,25,0.300000,0.300000,0.300000,99,68,31,false,0,31,310
ReactivePlayer,-100105,25,0.300000,0.300000,0.300000,99,69,30,false,0,30,275
ReactivePlayer,-79892,25,0.300000,0.300000,0.300000,79,72,7,true,1,7,184
ReactivePlayer,-8115,25,0.300000,0.300000,0.300000,9,9,0,true,1,0,41
ReactivePlayer,-100250,25,0.300000,0.300000,0.300000,99,84,15,false,0,15,266
ReactivePlayer,-17230,25,0.300000,0.300000,0.300000,18,11,7,true,1,7,83
ReactivePlayer,-100562,25,0.300000,0.300000,0.300000,99,74,25,false,0,25,365
ReactivePlayer,-100965,25,0.300000,0.300000,0.300000,100,82,18,false,0,18,270
ReactivePlayer,-100822,25,0.300000,0.300000,0.300000,100,87,13,false,0,13,172
ReactivePlayer,-100269,25,0.300000,0.300000,0.300000,99,82,17,false,0,17,239
ReactivePlayer,-29179,25,0.300000,0.300000,0.300000,30,25,5,true,1,5,94
ReactivePlayer,-100579,25,0.300000,0.300000,0.300000,99,82,17,false,0,17,246
ReactivePlayer,-100184,25,0.300000,0.300000,0.300000,99,87,12,false,0,12,192
ReactivePlayer,-100959,25,0.300000,0.300000,0.300000,99,80,19,false,0,19,373
ReactivePlayer,-62918,25,0.300000,0.300000,0.300000,63,45,18,true,1,18,234
ReactivePlayer,-34554,25,0.300000,0.300000,0.300000,35,21,14,true,1,14,144
ReactivePlayer,995,25,0.300000,0.300000,0.300000,0,0,0,true,1,0,4
ReactivePlayer,-100880,25,0.300000,0.300000,0.300000,100,76,24,false,0,24,224
ReactivePlayer,-1029,25,0.300000,0.300000,0.300000,2,0,2,true,1,2,22
ReactivePlayer,-100119,25,0.300000,0.300000,0.300000,99,72,27,false,0,27,292
ReactivePlayer,-100848,25,0.300000,0.300000,0.300000,100,84,16,false,0,16,210
ReactivePlayer,-82732,25,0.300000,0.300000,0.300000,82,65,17,true,1,17,169
ReactivePlayer,-39314,25,0.300000,0.300000,0.300000,40,32,8,true,1,8,94
ReactivePlayer,-100159,25,0.300000,0.300000,0.300000,99,78,21,false,0,21,248
ReactivePlayer,-100885,25,0.300000,0.300000,0.300000,100,85,15,false,0,15,215
ReactivePlayer,-100744,25,0.300000,0.300000,0.300000,99,76,23,false,0,23,246
ReactivePlayer,-96535,25,0.300000,0.300000,0.300000,96,65,31,true,1,31,394
ReactivePlayer,-2049,25,0.300000,0.300000,0.300000,3,1,2,true,1,2,26
ReactivePlayer,-100071,25,0.300000,0.300000,0.300000,99,78,21,false,0,21,298
ReactivePlayer,-100123,25,0.300000,0.300000,0.300000,99,80,19,false,0,19,273
ReactivePlayer,-100535,25,0.300000,0.300000,0.300000,99,81,18,false,0,18,213
ReactivePlayer,-100440,25,0.300000,0.300000,0.300000,99,72,27,false,0,27,347
ReactivePlayer,-11083,25,0.300000,0.300000,0.300000,12,5,7,true,1,7,34
ReactivePlayer,-18078,25,0.300000,0.300000,0.300000,19,15,4,true,1,4,39
ReactivePlayer,-100304,25,0.300000,0.300000,0.300000,99,73,26,false,0,26,361
ReactivePlayer,-100263,25,0.300000,0.300000,0.300000,99,93,6,false,0,6,93
ReactivePlayer,-100983,25,0.300000,0.300000,0.300000,100,88,12,false,0,12,137
ReactivePlayer,-100751,25,0.300000,0.300000,0.300000,99,79,20,false,0,20,296
ReactivePlayer,-1025,25,0.300000,0.300000,0.300000,2,1,1,true,1,1,12
ReactivePlayer,-68892,25,0.300000,0.300000,0.300000,69,51,18,true,1,18,232
ReactivePlayer,-100352,25,0.300000,0.300000,0.300000,99,83,16,false,0,16,265
ReactivePlayer,-100892,25,0.300000,0.300000,0.300000,100,80,20,false,0,20,157
ReactivePlayer,-100365,25,0.300000,0.300000,0.300000,99,84,15,false,0,15,248
ReactivePlayer,-100665,25,0.300000,0.300000,0.300000,99,80,19,false,0,19,252
ReactivePlayer,-100092,25,0.300000,0.300000,0.300000,99,71,28,false,0,28,273
ReactivePlayer,-100909,25,0.300000,0.300000,0.300000,100,77,23,false,0,23,285
ReactivePlayer,-100999,25,0.300000,0.300000,0.300000,100,75,25,false,0,25,274
ReactivePlayer,-100702,25,0.300000,0.300000,0.300000,99,88,11,false,0,11,194
ReactivePlayer,-100077,25,0.300000,0.300000,0.300000,98,64,34,false,0,34,429
ReactivePlayer,-100323,25,0.300000,0.300000,0.300000,99,82,17,false,0,17,179
ReactivePlayer,-23183,25,0.300000,0.300000,0.300000,24,18,6,true,1,6,66
ReactivePlayer,-100106,25,0.300000,0.300000,0.300000,99,90,9,false,0,9,251
ReactivePlayer,-100882,25,0.300000,0.300000,0.300000,100,77,23,false,0,23,239
ReactivePlayer,-100123,25,0.300000,0.300000,0.300000,99,80,19,false,0,19,198
ReactivePlayer,-100206,25,0.300000,0.300000,0.300000,99,84,15,false,0,15,224
ReactivePlayer,-100065,25,0.300000,0.300000,0.300000,99,69,30,false,0,30,287
ReactivePlayer,-100357,25,0.300000,0.300000,0.300000,99,73,26,false,0,26,273
ReactivePlayer,-100418,25,0.300000,0.300000,0.300000,99,82,17,false,0,17,183
ReactivePlayer,-100167,25,0.300000,0.300000,0.300000,99,86,13,false,0,13,175
ReactivePlayer,-100948,25,0.300000,0.300000,0.300000,100,90,10,false,0,10,181
ReactivePlayer,-100854,25,0.300000,0.300000,0.300000,100,84,16,false,0,16,217
ReactivePlayer,-26298,25,0.300000,0.300000,0.300000,27,18,9,true,1,9,119
ReactivePlayer,-100210,25,0.300000,0.300000,0.300000,99,81,18,false,0,18,267
ReactivePlayer,-100912,25,0.300000,0.300000,0.300000,100,82,18,false,0,18,185
ReactivePlayer,-63689,25,0.300000,0.300000,0.300000,64,53,11,true,1,11,174
ReactivePlayer,-100185,25,0.300000,0.300000,0.300000,99,77,22,false,0,22,330
ReactivePlayer,-8102,25,0.300000,0.300000,0.300000,9,4,5,true,1,5,49
ReactivePlayer,-3030,25,0.300000,0.300000,0.300000,4,4,0,true,1,0,12
ReactivePlayer,-100005,25,0.300000,0.300000,0.300000,99,88,11,false,0,11,183
ReactivePlayer,-100099,25,0.300000,0.300000,0.300000,99,86,13,false,0,13,187
ReactivePlayer,-100072,25,0.300000,0.300000,0.300000,98,76,22,false,0,22,371
ReactivePlayer,-95916,25,0.300000,0.300000,0.300000,96,72,24,true,1,24,192
ReactivePlayer,-100293,25,0.300000,0.300000,0.300000,99,79,20,false,0,20,280
ReactivePlayer,-71803,25,0.300000,0.300000,0.300000,72,55,17,true,1,17,199
ReactivePlayer,-100201,25,0.300000,0.300000,0.300000,99,76,23,false,0,23,303
ReactivePlayer,-100969,25,0.300000,0.300000,0.300000,100,68,32,false,0,32,257
ReactivePlayer,-100015,25,0.300000,0.300000,0.300000,99,82,17,false,0,17,239
ReactivePlayer,-11187,25,0.300000,0.300000,0.300000,12,8,4,true,1,4,61
ReactivePlayer,-100786,25,0.300000,0.300000,0.300000,100,78,22,false,0,22,262
ReactivePlayer,-47871,25,0.300000,0.300000,0.300000,48,33,15,true,1,15,157
ReactivePlayer,-41500,25,0.300000,0.300000,0.300000,42,33,9,true,1,9,205
ReactivePlayer,-85944,25,0.300000,0.300000,0.300000,86,74,12,true,1,12,179
ReactivePlayer,-100261,25,0.300000,0.300000,0.300000,99,79,20,false,0,20,241
ReactivePlayer,-100859,25,0.300000,0.300000,0.300000,99,73,26,false,0,26,322
ReactivePlayer,-100987,25,0.300000,0.300000,0.300000,100,82,18,false,0,18,240
ReactivePlayer,-86571,25,0.300000,0.300000,0.300000,87,83,4,true,1,4,98
ReactivePlayer,-100911,25,0.300000,0.300000,0.300000,100,80,20,false,0,20,225
ReactivePlayer,-62687,25,0.300000,0.300000,0.300000,63,48,15,true,1,15,186
ReactivePlayer,-100564,25,0.300000,0.300000,0.300000,99,81,18,false,0,18,324
ReactivePlayer,-100286,25,0.300000,0.300000,0.300000,99,88,11,false,0,11,174
ReactivePlayer,-100252,25,0.300000,0.300000,0.300000,99,73,26,false,0,26,260
ReactivePlayer,-100958,25,0.300000,0.300000,0.300000,100,91,9,false,0,9,186
ReactivePlayer,-100300,25,0.300000,0.300000,0.300000,99,80,19,false,0,19,222
ReactivePlayer,-100828,25,0.300000,0.300000,0.300000,100,85,15,false,0,15,230
ReactivePlayer,-100923,25,0.300000,0.300000,0.300000,100,84,16,false,0,16,166
ReactivePlayer,-100475,25,0.300000,0.300000,0.300000,99,81,18,false,0,18,334
ReactivePlayer,-100849,25,0.300000,0.300000,0.300000,100,84,16,false,0,16,190
ReactivePlayer,-100000,25,0.300000,0.300000,0.300000,99,82,17,false,0,17,229
ReactivePlayer,-100054,25,0.300000,0.300000,0.300000,99,84,15,false,0,15,253
ReactivePlayer,-100100,25,0.300000,0.300000,0.300000,98,78,20,false,0,20,274
ReactivePlayer,-59980,25,0.300000,0.300000,0.300000,60,41,19,true,1,19,286
ReactivePlayer,-49812,25,0.300000,0.300000,0.300000,50,43,7,true,1,7,141
ReactivePlayer,-31487,25,0.300000,0.300000,0.300000,32,22,10,true,1,10,138
ReactivePlayer,-100192,25,0.300000,0.300000,0.300000,99,83,16,false,0,16,201
ReactivePlayer,-100046,25,0.300000,0.300000,0.300000,99,88,11,false,0,11,188
ReactivePlayer,-83893,25,0.300000,0.300000,0.300000,84,75,9,true,1,9,166
ReactivePlayer,-18201,25,0.300000,0.300000,0.300000,19,12,7,true,1,7,92
ReactivePlayer,-100579,25,0.300000,0.300000,0.300000,99,93,6,false,0,6,114
ReactivePlayer,-100247,25,0.300000,0.300000,0.300000,99,76,23,false,0,23,306
ReactivePlayer,-100835,25,0.300000,0.300000,0.300000,99,79,20,false,0,20,307
ReactivePlayer,-100126,25,0.300000,0.300000,0.300000,99,84,15,false,0,15,236
ReactivePlayer,-100936,25,0.300000,0.300000,0.300000,100,81,19,false,0,19,236
ReactivePlayer,-100511,25,0.300000,0.300000,0.300000,99,81,18,false,0,18,208
ReactivePlayer,-100872,25,0.300000,0.300000,0.300000,100,91,9,false,0,9,160
ReactivePlayer,-3063,25,0.300000,0.300000,0.300000,4,3,1,true,1,1,25
ReactivePlayer,-25326,25,0.300000,0.300000,0.300000,26,18,8,true,1,8,101
ReactivePlayer,-100383,25,0.300000,0.300000,0.300000,99,84,15,false,0,15,255
ReactivePlayer,-100629,25,0.300000,0.300000,0.300000,99,81,18,false,0,18,290
ReactivePlayer,-100439,25,0.300000,0.300000,0.300000,99,81,18,false,0,18,205
ReactivePlayer,-100050,25,0.300000,0.300000,0.300000,99,81,18,false,0,18,244
ReactivePlayer,-4022,25,0.300000,0.300000,0.300000,5,3,2,true,1,2,12
ReactivePlayer,-100337,25,0.300000,0.300000,0.300000,99,71,28,false,0,28,322
ReactivePlayer,-100160,25,0.300000,0.300000,0.300000,99,81,18,false,0,18,247
ReactivePlayer,-100719,25,0.300000,0.300000,0.300000,100,85,15,false,0,15,140
ReactivePlayer,-100901,25,0.300000,0.300000,0.300000,100,83,17,false,0,17,239
ReactivePlayer,-100115,25,0.300000,0.300000,0.300000,99,77,22,false,0,22,231
ReactivePlayer,-6082,25,0.300000,0.300000,0.300000,7,6,1,true,1,1,22
ReactivePlayer,-100790,25,0.300000,0.300000,0.300000,100,92,8,false,0,8,143
ReactivePlayer,-100990,25,0.300000,0.300000,0.300000,99,72,27,false,0,27,312
ReactivePlayer,-100277,25,0.300000,0.300000,0.300000,99,77,22,false,0,22,262
ReactivePlayer,-42769,25,0.300000,0.300000,0.300000,43,22,21,true,1,21,183
ReactivePlayer,-100749,25,0.300000,0.300000,0.300000,99,79,20,false,0,20,257
ReactivePlayer,-43985,25,0.300000,0.300000,0.300000,44,29,15,true,1,15,224
ReactivePlayer,-100164,25,0.300000,0.300000,0.300000,99,91,8,false,0,8,138
ReactivePlayer,-100810,25,0.300000,0.300000,0.300000,99,82,17,false,0,17,267
ReactivePlayer,-100805,25,0.300000,0.300000,0.300000,100,81,19,false,0,19,225
ReactivePlayer,-100477,25,0.300000,0.300000,0.300000,99,79,20,false,0,20,294
ReactivePlayer,-100689,25,0.300000,0.300000,0.300000,100,83,17,false,0,17,197
ReactivePlayer,996,25,0.300000,0.300000,0.300000,0,0,0,true,1,0,4
ReactivePlayer,-100871,25,0.300000,0.300000,0.300000,100,89,11,false,0,11,202
ReactivePlayer,-100652,25,0.300000,0.300000,0.300000,100,82,18,false,0,18,173
ReactivePlayer,-100020,25,0.300000,0.300000,0.300000,99,85,14,false,0,14,197
ReactivePlayer,-73836,25,0.300000,0.300000,0.300000,74,54,20,true,1,20,253
ReactivePlayer,-69860,25,0.300000,0.300000,0.300000,70,55,15,true,1,15,169
ReactivePlayer,-100859,25,0.300000,0.300000,0.300000,100,86,14,false,0,14,243
ReactivePlayer,-17313,25,0.300000,0.300000,0.300000,18,9,9,true,1,9,86
ReactivePlayer,-10311,25,0.300000,0.300000,0.300000,11,8,3,true,1,3,58
ReactivePlayer,-100828,25,0.300000,0.300000,0.300000,99,79,20,false,0,20,318
ReactivePlayer,-100780,25,0.300000,0.300000,0.300000,100,91,9,false,0,9,120
ReactivePlayer,-18133,25,0.300000,0.300000,0.300000,19,17,2,true,1,2,63
ReactivePlayer,-100247,25,0.300000,0.300000,0.300000,99,89,10,false,0,10,196
ReactivePlayer,-100396,25,0.300000,0.300000,0.300000,99,86,13,false,0,13,254
ReactivePlayer,-100779,25,0.300000,0.300000,0.300000,99,82,17,false,0,17,316
ReactivePlayer,-100222,25,0.300000,0.300000,0.300000,99,71,28,false,0,28,258
ReactivePlayer,-100630,25,0.300000,0.300000,0.300000,99,83,16,false,0,16,193
ReactivePlayer,-100464,25,0.300000,0.300000,0.300000,99,86,13,false,0,13,248
ReactivePlayer,-7151,25,0.300000,0.300000,0.300000,8,5,3,true,1,3,61
ReactivePlayer,-100192,25,0.300000,0.300000,0.300000,99,87,12,false,0,12,176
ReactivePlayer,-100623,25,0.300000,0.300000,0.300000,99,88,11,false,0,11,167
ReactivePlayer,-6210,25,0.300000,0.300000,0.300000,7,5,2,true,1,2,52
ReactivePlayer,-100094,25,0.300000,0.300000,0.300000,99,84,15,false,0,15,197
ReactivePlayer,-100752,25,0.300000,0.300000,0.300000,100,82,18,false,0,18,148
ReactivePlayer,-100194,25,0.300000,0.300000,0.300000,99,84,15,false,0,15,256
ReactivePlayer,-100877,25,0.300000,0.300000,0.300000,100,85,15,false,0,15,171
ReactivePlayer,-100188,25,0.300000,0.300000,0.300000,99,77,22,false,0,22,280
ReactivePlayer,-100590,25,0.300000,0.300000,0.300000,100,93,7,false,0,7,122
ReactivePlayer,-100547,25,0.300000,0.300000,0.300000,99,78,21,false,0,21,254
ReactivePlayer,-100048,25,0.300000,0.300000,0.300000,99,78,21,false,0,21,284
ReactivePlayer,-79878,25,0.300000,0.300000,0.300000,80,66,14,true,1,14,229
ReactivePlayer,-23188,25,0.300000,0.300000,0.300000,24,21,3,true,1,3,64
ReactivePlayer,-75608,25,0.300000,0.300000,0.300000,75,57,18,true,1,18,314
ReactivePlayer,-100943,25,0.300000,0.300000,0.300000,100,87,13,false,0,13,258
ReactivePlayer,-100777,25,0.300000,0.300000,0.300000,100,97,3,false,0,3,101
ReactivePlayer,-100091,25,0.300000,0.300000,0.300000,99,86,13,false,0,13,184
ReactivePlayer,-100292,25,0.300000,0.300000,0.300000,99,72,27,false,0,27,211
ReactivePlayer,-100888,25,0.300000,0.300000,0.300000,100,70,30,false,0,30,259
ReactivePlayer,-100161,25,0.300000,0.300000,0.300000,99,82,17,false,0,17,231
ReactivePlayer,-100341,25,0.300000,0.300000,0.300000,99,81,18,false,0,18,288
ReactivePlayer,-100951,25,0.300000,0.300000,0.300000,100,81,19,false,0,19,273
ReactivePlayer,-95930,25,0.300000,0.300000,0.300000,96,83,13,true,1,13,209
ReactivePlayer,-53874,25,0.300000,0.300000,0.300000,54,38,16,true,1,16,157
ReactivePlayer,-100215,25,0.300000,0.300000,0.300000,99,82,17,false,0,17,240
ReactivePlayer,-100102,25,0.300000,0.300000,0.300000,99,80,19,false,0,19,209
ReactivePlayer,-100212,25,0.300000,0.300000,0.300000,99,73,26,false,0,26,365
ReactivePlayer,-100640,25,0.300000,0.300000,0.300000,100,92,8,false,0,8,127
ReactivePlayer,-100934,25,0.300000,0.300000,0.300000,100,90,10,false,0,10,177
ReactivePlayer,-21227,25,0.300000,0.300000,0.300000,22,15,7,true,1,7,92
ReactivePlayer,-72699,25,0.300000,0.300000,0.300000,73,58,15,true,1,15,172
ReactivePlayer,-17195,25,0.300000,0.300000,0.300000,18,13,5,true,1,5,95
ReactivePlayer,-100325,25,0.300000,0.300000,0.300000,99,91,8,false,0,8,207
ReactivePlayer,-16134,25,0.300000,0.300000,0.300000,17,14,3,true,1,3,64
ReactivePlayer,-100053,25,0.300000,0.300000,0.300000,99,83,16,false,0,16,198
ReactivePlayer,-20526,25,0.300000,0.300000,0.300000,21,13,8,true,1,8,114
ReactivePlayer,-57974,25,0.300000,0.300000,0.300000,58,51,7,true,1,7,180
ReactivePlayer,-77901,25,0.300000,0.300000,0.300000,78,55,23,true,1,23,247
ReactivePlayer,-100790,25,0.300000,0.300000,0.300000,99,73,26,false,0,26,346
ReactivePlayer,-87712,25,0.300000,0.300000,0.300000,88,70,18,true,1,18,200
ReactivePlayer,-100548,25,0.300000,0.300000,0.300000,99,84,15,false,0,15,248
ReactivePlayer,-100424,25,0.300000,0.300000,0.300000,99,71,28,false,0,28,274
ReactivePlayer,-100799,25,0.300000,0.300000,0.300000,100,96,4,false,0,4,111
ReactivePlayer,-100145,25,0.300000,0.300000,0.300000,99,81,18,false,0,18,286
ReactivePlayer,-100925,25,0.300000,0.300000,0.300000,100,90,10,false,0,10,172
ReactivePlayer,-2089,25,0.300000,0.300000,0.300000,3,1,2,true,1,2,43
ReactivePlayer,-85648,25,0.300000,0.300000,0.300000,86,69,17,true,1,17,213
ReactivePlayer,-68059,25,0.300000,0.300000,0.300000,68,54,14,true,1,14,226
ReactivePlayer,-100819,25,0.300000,0.300000,0.300000,100,86,14,false,0,14,184
ReactivePlayer,-90696,25,0.300000,0.300000,0.300000,91,77,14,true,1,14,158
ReactivePlayer,-100818,25,0.300000,0.300000,0.300000,100,75,25,false,0,25,255
ReactivePlayer,-100094,25,0.300000,0.300000,0.300000,99,78,21,false,0,21,235
ReactivePlayer,-61424,25,0.300000,0.300000,0.300000,62,56,6,true,1,6,114
ReactivePlayer,-100665,25,0.300000,0.300000,0.300000,100,85,15,false,0,15,175
ReactivePlayer,-100292,25,0.300000,0.300000,0.300000,99,87,12,false,0,12,151
ReactivePlayer,-100848,25,0.300000,0.300000,0.300000,100,91,9,false,0,9,181
ReactivePlayer,-100596,25,0.300000,0.300000,0.300000,100,90,10,false,0,10,140
ReactivePlayer,-100967,25,0.300000,0.300000,0.300000,100,89,11,false,0,11,237
ReactivePlayer,-100728,25,0.300000,0.300000,0.300000,99,74,25,false,0,25,328
ReactivePlayer,-100044,25,0.300000,0.300000,0.300000,99,81,18,false,0,18,231
ReactivePlayer,-47974,25,0.300000,0.300000,0.300000,48,38,10,true,1,10,149
ReactivePlayer,-100862,25,0.300000,0.300000,0.300000,100,84,16,false,0,16,196
ReactivePlayer,-100807,25,0.300000,0.300000,0.300000,100,81,19,false,0,19,208
ReactivePlayer,-100321,25,0.300000,0.300000,0.300000,99,66,33,false,0,33,357
ReactivePlayer,-57749,25,0.300000,0.300000,0.300000,58,39,19,true,1,19,219
ReactivePlayer,-100418,25,0.300000,0.300000,0.300000,99,76,23,false,0,23,289
ReactivePlayer,-100706,25,0.300000,0.300000,0.300000,100,70,30,false,0,30,253
ReactivePlayer,-100978,25,0.300000,0.300000,0.300000,100,83,17,false,0,17,199
ReactivePlayer,-98406,25,0.300000,0.300000,0.300000,98,84,14,true,1,14,232
ReactivePlayer,966,25,0.300000,0.300000,0.300000,0,0,0,true,1,0,16
ReactivePlayer,-100795,25,0.300000,0.300000,0.300000,99,79,20,false,0,20,275
ReactivePlayer,-100110,25,0.300000,0.300000,0.300000,99,87,12,false,0,12,205
ReactivePlayer,-85008,25,0.300000,0.300000,0.300000,85,61,24,true,1,24,261
ReactivePlayer,-33469,25,0.300000,0.300000,0.300000,34,23,11,true,1,11,110
ReactivePlayer,-40402,25,0.300000,0.300000,0.300000,41,33,8,true,1,8,112
ReactivePlayer,-54584,25,0.300000,0.300000,0.300000,55,44,11,true,1,11,147
ReactivePlayer,-8,25,0.300000,0.300000,0.300000,1,1,0,true,1,0,7
ReactivePlayer,-100335,25,0.300000,0.300000,0.300000,99,80,19,false,0,19,235
ReactivePlayer,-57884,25,0.300000,0.300000,0.300000,58,46,12,true,1,12,185
ReactivePlayer,-12097,25,0.300000,0.300000,0.300000,13,10,3,true,1,3,41
ReactivePlayer,-100133,25,0.300000,0.300000,0.300000,99,77,22,false,0,22,313
ReactivePlayer,-100757,25,0.300000,0.300000,0.300000,100,87,13,false,0,13,171
ReactivePlayer,-100374,25,0.300000,0.300000,0.300000,99,71,28,false,0,28,324
ReactivePlayer,-100214,25,0.300000,0.300000,0.300000,99,78,21,false,0,21,194
ReactivePlayer,-100784,25,0.300000,0.300000,0.300000,100,86,14,false,0,14,187
ReactivePlayer,-100007,25,0.300000,0.300000,0.300000,99,86,13,false,0,13,171
ReactivePlayer,-100975,25,0.300000,0.300000,0.300000,100,86,14,false,0,14,219
ReactivePlayer,-100204,25,0.300000,0.300000,0.300000,99,67,32,false,0,32,355
ReactivePlayer,-100367,25,0.300000,0.300000,0.300000,99,65,34,false,0,34,306
ReactivePlayer,-100041,25,0.300000,0.300000,0.300000,99,77,22,false,0,22,294
ReactivePlayer,-13122,25,0.300000,0.300000,0.300000,14,12,2,true,1,2,25
ReactivePlayer,-100403,25,0.300000,0.300000,0.300000,99,85,14,false,0,14,245
ReactivePlayer,-100017,25,0.300000,0.300000,0.300000,99,86,13,false,0,13,236
ReactivePlayer,-85146,25,0.300000,0.300000,0.300000,85,67,18,true,1,18,252
ReactivePlayer,-94166,25,0.300000,0.300000,0.300000,94,80,14,true,1,14,211
ReactivePlayer,-100720,25,0.300000,0.300000,0.300000,100,94,6,false,0,6,115
ReactivePlayer,-100314,25,0.300000,0.300000,0.300000,99,79,20,false,0,20,270
ReactivePlayer,-100337,25,0.300000,0.300000,0.300000,99,91,8,false,0,8,239
ReactivePlayer,-62844,25,0.300000,0.300000,0.300000,63,54,9,true,1,9,168
ReactivePlayer,-35733,25,0.300000,0.300000,0.300000,36,26,10,true,1,10,157
ReactivePlayer,-100187,25,0.300000,0.300000,0.300000,99,88,11,false,0,11,198
ReactivePlayer,-100247,25,0.300000,0.300000,0.300000,99,83,16,false,0,16,272
ReactivePlayer,-38670,25,0.300000,0.300000,0.300000,39,29,10,true,1,10,171
ReactivePlayer,-100951,25,0.300000,0.300000,0.300000,100,80,20,false,0,20,254
ReactivePlayer,-100991,25,0.300000,0.300000,0.300000,100,85,15,false,0,15,246
ReactivePlayer,-100413,25,0.300000,0.300000,0.300000,99,85,14,false,0,14,288
ReactivePlayer,-100012,25,0.300000,0.300000,0.300000,99,84,15,false,0,15,279
ReactivePlayer,-100216,25,0.300000,0.300000,0.300000,99,84,15,false,0,15,221
ReactivePlayer,-100980,25,0.300000,0.300000,0.300000,100,90,10,false,0,10,197
ReactivePlayer,-100034,25,0.300000,0.300000,0.300000,99,79,20,false,0,20,203
ReactivePlayer,-59,25,0.300000,0.300000,0.300000,1,0,1,true,1,1,27
ReactivePlayer,-91163,25,0.300000,0.300000,0.300000,91,72,19,true,1,19,303
ReactivePlayer,-38799,25,0.300000,0.300000,0.300000,39,30,9,true,1,9,165
ReactivePlayer,-100009,25,0.300000,0.300000,0.300000,99,82,17,false,0,17,204
ReactivePlayer,-26268,25,0.300000,0.300000,0.300000,27,21,6,true,1,6,83
ReactivePlayer,-100453,25,0.300000,0.300000,0.300000,99,76,23,false,0,23,310
ReactivePlayer,-11256,25,0.300000,0.300000,0.300000,12,8,4,true,1,4,88
ReactivePlayer,-100148,25,0.300000,0.300000,0.300000,99,85,14,false,0,14,242
ReactivePlayer,-100553,25,0.300000,0.300000,0.300000,99,79,20,false,0,20,278
ReactivePlayer,-74583,25,0.300000,0.300000,0.300000,75,64,11,true,1,11,176
ReactivePlayer,-100103,25,0.300000,0.300000,0.300000,99,87,12,false,0,12,177
ReactivePlayer,-100490,25,0.300000,0.300000,0.300000,99,79,20,false,0,20,297
ReactivePlayer,-4050,25,0.300000,0.300000,0.300000,5,3,2,true,1,2,29
ReactivePlayer,-100576,25,0.300000,0.300000,0.300000,99,82,17,false,0,17,222
ReactivePlayer,-36500,25,0.300000,0.300000,0.300000,37,30,7,true,1,7,119
ReactivePlayer,-100206,25,0.300000,0.300000,0.300000,99,83,16,false,0,16,134
ReactivePlayer,-100699,25,0.300000,0.300000,0.300000,100,91,9,false,0,9,123
ReactivePlayer,-9118,25,0.300000,0.300000,0.300000,10,4,6,true,1,6,53
ReactivePlayer,-91616,25,0.300000,0.300000,0.300000,91,69,22,true,1,22,310
ReactivePlayer,-100861,25,0.300000,0.300000,0.300000,100,76,24,false,0,24,228
ReactivePlayer,-100138,25,0.300000,0.300000,0.300000,99,88,11,false,0,11,167
ReactivePlayer,-100880,25,0.300000,0.300000,0.300000,100,87,13,false,0,13,191
ReactivePlayer,-100161,25,0.300000,0.300000,0.300000,99,85,14,false,0,14,209
ReactivePlayer,-100666,25,0.300000,0.300000,0.300000,100,95,5,false,0,5,101
ReactivePlayer,-100259,25,0.300000,0.300000,0.300000,99,88,11,false,0,11,159
ReactivePlayer,-100364,25,0.300000,0.300000,0.300000,99,75,24,false,0,24,269
ReactivePlayer,-100389,25,0.300000,0.300000,0.300000,99,83,16,false,0,16,245
ReactivePlayer,-67491,25,0.300000,0.300000,0.300000,68,58,10,true,1,10,106
ReactivePlayer,-100255,25,0.300000,0.300000,0.300000,98,76,22,false,0,22,350
ReactivePlayer,-100910,25,0.300000,0.300000,0.300000,100,89,11,false,0,11,156
ReactivePlayer,-100615,25,0.300000,0.300000,0.300000,99,88,11,false,0,11,193
ReactivePlayer,-100000,25,0.300000,0.300000,0.300000,99,89,10,false,0,10,121
ReactivePlayer,-53419,25,0.300000,0.300000,0.300000,54,41,13,true,1,13,155
ReactivePlayer,-100340,25,0.300000,0.300000,0.300000,99,89,10,false,0,10,105
ReactivePlayer,-100782,25,0.300000,0.300000,0.300000,100,88,12,false,0,12,195
ReactivePlayer,-100214,25,0.300000,0.300000,0.300000,99,81,18,false,0,18,239
ReactivePlayer,-100373,25,0.300000,0.300000,0.300000,99,75,24,false,0,24,265
ReactivePlayer,-100704,25,0.300000,0.300000,0.300000,100,85,15,false,0,15,174
ReactivePlayer,-100643,25,0.300000,0.300000,0.300000,99,77,22,false,0,22,259
ReactivePlayer,-25230,25,0.300000,0.300000,0.300000,26,21,5,true,1,5,84
ReactivePlayer,-100763,25,0.300000,0.300000,0.300000,100,95,5,false,0,5,107
ReactivePlayer,-100636,25,0.300000,0.300000,0.300000,99,79,20,false,0,20,271
ReactivePlayer,-100915,25,0.300000,0.300000,0.300000,99,72,27,false,0,27,284
ReactivePlayer,-100082,25,0.300000,0.300000,0.300000,99,86,13,false,0,13,194
ReactivePlayer,-100534,25,0.300000,0.300000,0.300000,99,85,14,false,0,14,286
ReactivePlayer,-100710,25,0.300000,0.300000,0.300000,99,73,26,false,0,26,333
ReactivePlayer,-100427,25,0.300000,0.300000,0.300000,99,92,7,false,0,7,122
ReactivePlayer,-100080,25,0.300000,0.300000,0.300000,99,72,27,false,0,27,289
ReactivePlayer,-28368,25,0.300000,0.300000,0.300000,29,20,9,true,1,9,140
ReactivePlayer,-100153,25,0.300000,0.300000,0.300000,99,84,15,false,0,15,197
ReactivePlayer,-100113,25,0.300000,0.300000,0.300000,99,80,19,false,0,19,233
ReactivePlayer,-100096,25,0.300000,0.300000,0.300000,99,82,17,false,0,17,221
ReactivePlayer,-100988,25,0.300000,0.300000,0.300000,100,78,22,false,0,22,249
ReactivePlayer,-100231,25,0.300000,0.300000,0.300000,99,88,11,false,0,11,215
ReactivePlayer,-3097,25,0.300000,0.300000,0.300000,4,0,4,true,1,4,45
ReactivePlayer,-44512,25,0.300000,0.300000,0.300000,44,28,16,true,1,16,276
ReactivePlayer,-100515,25,0.300000,0.300000,0.300000,99,83,16,false,0,16,251
ReactivePlayer,-100445,25,0.300000,0.300000,0.300000,99,92,7,false,0,7,174
ReactivePlayer,-100853,25,0.300000,0.300000,0.300000,100,87,13,false,0,13,156
ReactivePlayer,-100415,25,0.300000,0.300000,0.300000,99,73,26,false,0,26,275
ReactivePlayer,-100379,25,0.300000,0.300000,0.300000,99,84,15,false,0,15,248
ReactivePlayer,-100532,25,0.300000,0.300000,0.300000,99,75,24,false,0,24,304
ReactivePlayer,-100633,25,0.300000,0.300000,0.300000,99,76,23,false,0,23,222
ReactivePlayer,-100911,25,0.300000,0.300000,0.300000,100,84,16,false,0,16,178
ReactivePlayer,-53606,25,0.300000,0.300000,0.300000,54,35,19,true,1,19,162
ReactivePlayer,-100825,25,0.300000,0.300000,0.300000,100,93,7,false,0,7,166
ReactivePlayer,-100467,25,0.300000,0.300000,0.300000,99,80,19,false,0,19,287
ReactivePlayer,-75197,25,0.300000,0.300000,0.300000,75,53,22,true,1,22,258
ReactivePlayer,-100256,25,0.300000,0.300000,0.300000,99,73,26,false,0,26,319
ReactivePlayer,-100020,25,0.300000,0.300000,0.300000,99,71,28,false,0,28,257
ReactivePlayer,-100190,25,0.300000,0.300000,0.300000,99,84,15,false,0,15,213
ReactivePlayer,-100341,25,0.300000,0.300000,0.300000,99,89,10,false,0,10,311
ReactivePlayer,-62891,25,0.300000,0.300000,0.300000,63,37,26,true,1,26,248
ReactivePlayer,-49596,25,0.300000,0.300000,0.300000,50,39,11,true,1,11,190
ReactivePlayer,-6118,25,0.300000,0.300000,0.300000,7,5,2,true,1,2,53
ReactivePlayer,-37458,25,0.300000,0.300000,0.300000,38,23,15,true,1,15,174
ReactivePlayer,-100959,25,0.300000,0.300000,0.300000,100,79,21,false,0,21,249
ReactivePlayer,-62331,25,0.300000,0.300000,0.300000,63,57,6,true,1,6,109
ReactivePlayer,-32356,25,0.300000,0.300000,0.300000,33,20,13,true,1,13,149
ReactivePlayer,-100088,25,0.300000,0.300000,0.300000,99,90,9,false,0,9,158
ReactivePlayer,-100142,25,0.300000,0.300000,0.300000,99,76,23,false,0,23,324
ReactivePlayer,-75273,25,0.300000,0.300000,0.300000,75,63,12,true,1,12,253
ReactivePlayer,-100000,25,0.300000,0.300000,0.300000,99,82,17,false,0,17,260
ReactivePlayer,-100286,25,0.300000,0.300000,0.300000,99,85,14,false,0,14,223
ReactivePlayer,-66048,25,0.300000,0.300000,0.300000,66,53,13,true,1,13,204
ReactivePlayer,-100882,25,0.300000,0.300000,0.300000,100,74,26,false,0,26,239
ReactivePlayer,-86106,25,0.300000,0.300000,0.300000,86,57,29,true,1,29,266
ReactivePlayer,-100708,25,0.300000,0.300000,0.300000,99,71,28,false,0,28,359
ReactivePlayer,-100904,25,0.300000,0.300000,0.300000,100,87,13,false,0,13,148
ReactivePlayer,-100671,25,0.300000,0.300000,0.300000,100,88,12,false,0,12,184
ReactivePlayer,-100964,25,0.300000,0.300000,0.300000,100,78,22,false,0,22,244
ReactivePlayer,-33616,25,0.300000,0.300000,0.300000,34,22,12,true,1,12,196
ReactivePlayer,-100306,25,0.300000,0.300000,0.300000,99,77,22,false,0,22,300
ReactivePlayer,-100165,25,0.300000,0.300000,0.300000,99,69,30,false,0,30,307
ReactivePlayer,-5,25,0.300000,0.300000,0.300000,1,0,1,true,1,1,5
ReactivePlayer,-100982,25,0.300000,0.300000,0.300000,100,80,20,false,0,20,208
ReactivePlayer,-41325,25,0.300000,0.300000,0.300000,42,36,6,true,1,6,111
ReactivePlayer,-100224,25,0.300000,0.300000,0.300000,99,85,14,false,0,14,214
ReactivePlayer,-13330,25,0.300000,0.300000,0.300000,14,8,6,true,1,6,92
ReactivePlayer,-100950,25,0.300000,0.300000,0.300000,100,76,24,false,0,24,232
ReactivePlayer,-62665,25,0.300000,0.300000,0.300000,63,54,9,true,1,9,193
ReactivePlayer,-43377,25,0.300000,0.300000,0.300000,44,32,12,true,1,12,106
ReactivePlayer,-100496,25,0.300000,0.300000,0.300000,99,80,19,false,0,19,285
ReactivePlayer,-100782,25,0.300000,0.300000,0.300000,99,72,27,false,0,27,374
ReactivePlayer,-3039,25,0.300000,0.300000,0.300000,4,1,3,true,1,3,24
ReactivePlayer,-100271,25,0.300000,0.300000,0.300000,99,91,8,false,0,8,150
ReactivePlayer,-100578,25,0.300000,0.300000,0.300000,99,68,31,false,0,31,344
ReactivePlayer,-100858,25,0.300000,0.300000,0.300000,100,90,10,false,0,10,163
ReactivePlayer,-100809,25,0.300000,0.300000,0.300000,99,75,24,false,0,24,305
ReactivePlayer,-23502,25,0.300000,0.300000,0.300000,24,16,8,true,1,8,119
ReactivePlayer,-100270,25,0.300000,0.300000,0.300000,99,78,21,false,0,21,293
ReactivePlayer,-12114,25,0.300000,0.300000,0.300000,13,11,2,true,1,2,38
ReactivePlayer,-44547,25,0.300000,0.300000,0.300000,45,35,10,true,1,10,165
ReactivePlayer,-100062,25,0.300000,0.300000,0.300000,98,87,11,false,0,11,224
ReactivePlayer,-100135,25,0.300000,0.300000,0.300000,99,89,10,false,0,10,195
ReactivePlayer,-100100,25,0.300000,0.300000,0.300000,99,72,27,false,0,27,345
ReactivePlayer,-100984,25,0.300000,0.300000,0.300000,99,76,23,false,0,23,303
ReactivePlayer,-100299,25,0.300000,0.300000,0.300000,99,76,23,false,0,23,291
ReactivePlayer,-3025,25,0.300000,0.300000,0.300000,4,3,1,true,1,1,17
ReactivePlayer,-100839,25,0.300000,0.300000,0.300000,100,83,17,false,0,17,159
ReactivePlayer,-100335,25,0.300000,0.300000,0.300000,99,76,23,false,0,23,342
ReactivePlayer,-100551,25,0.300000,0.300000,0.300000,99,80,19,false,0,19,249
ReactivePlayer,-100557,25,0.300000,0.300000,0.300000,99,80,19,false,0,19,276
ReactivePlayer,-100249,25,0.300000,0.300000,0.300000,99,78,21,false,0,21,269
ReactivePlayer,-2075,25,0.300000,0.300000,0.300000,3,3,0,true,1,0,36
ReactivePlayer,-100754,25,0.300000,0.300000,0.300000,100,80,20,false,0,20,256
ReactivePlayer,-100350,25,0.300000,0.300000,0.300000,99,79,20,false,0,20,286
ReactivePlayer,-90252,25,0.300000,0.300000,0.300000,90,68,22,true,1,22,315
ReactivePlayer,-100096,25,0.300000,0.300000,0.300000,99,86,13,false,0,13,189
ReactivePlayer,-48362,25,0.300000,0.300000,0.300000,49,41,8,true,1,8,131
ReactivePlayer,-46609,25,0.300000,0.300000,0.300000,47,40,7,true,1,7,111
ReactivePlayer,-66167,25,0.300000,0.300000,0.300000,66,51,15,true,1,15,219
ReactivePlayer,-73816,25,0.300000,0.300000,0.300000,74,57,17,true,1,17,261
ReactivePlayer,-100076,25,0.300000,0.300000,0.300000,99,87,12,false,0,12,137
ReactivePlayer,-100064,25,0.300000,0.300000,0.300000,99,74,25,false,0,25,223
ReactivePlayer,-7,25,0.300000,0.300000,0.300000,1,1,0,true,1,0,6
ReactivePlayer,-100110,25,0.300000,0.300000,0.300000,99,81,18,false,0,18,258
ReactivePlayer,-100805,25,0.300000,0.300000,0.300000,100,87,13,false,0,13,161
ReactivePlayer,-100540,25,0.300000,0.300000,0.300000,99,79,20,false,0,20,306
