Player Type,Total Score,World Size,Wumpus Probability,Obstacle Probability,Pit Probability,Total Deaths,Pit Deaths,Wumpus Deaths,Have gold,Have gold int,WumpusKilled,RoomsExplored
ReactivePlayer,1000,10,0.300000,0.300000,0.300000,0,0,0,true,1,0,0
ReactivePlayer,-79202,10,0.300000,0.300000,0.300000,79,70,9,true,1,9,98
ReactivePlayer,-7056,10,0.300000,0.300000,0.300000,8,5,3,true,1,3,23
ReactivePlayer,-16251,10,0.300000,0.300000,0.300000,17,13,4,true,1,4,67
ReactivePlayer,-13118,10,0.300000,0.300000,0.300000,14,12,2,true,1,2,46
ReactivePlayer,-10213,10,0.300000,0.300000,0.300000,11,7,4,true,1,4,57
ReactivePlayer,-10657,10,0.300000,0.300000,0.300000,11,8,3,true,1,3,51
ReactivePlayer,-6068,10,0.300000,0.300000,0.300000,7,2,5,true,1,5,34
ReactivePlayer,-7110,10,0.300000,0.300000,0.300000,8,5,3,true,1,3,46
ReactivePlayer,-3059,10,0.300000,0.300000,0.300000,4,1,3,true,1,3,28
ReactivePlayer,-31842,10,0.300000,0.300000,0.300000,32,26,6,true,1,6,68
ReactivePlayer,-42417,10,0.300000,0.300000,0.300000,43,41,2,true,1,2,54
ReactivePlayer,-3057,10,0.300000,0.300000,0.300000,4,3,1,true,1,1,30
ReactivePlayer,-4055,10,0.300000,0.300000,0.300000,5,2,3,true,1,3,26
ReactivePlayer,-68,10,0.300000,0.300000,0.300000,1,0,1,true,1,1,27
ReactivePlayer,-28590,10,0.300000,0.300000,0.300000,29,24,5,true,1,5,84
ReactivePlayer,-11100,10,0.300000,0.300000,0.300000,12,8,4,true,1,4,29
ReactivePlayer,-100743,10,0.300000,0.300000,0.300000,100,96,4,false,0,4,82
ReactivePlayer,-18246,10,0.300000,0.300000,0.300000,19,12,7,true,1,7,73
ReactivePlayer,-2013,10,0.300000,0.300000,0.300000,3,3,0,true,1,0,7
ReactivePlayer,-14312,10,0.300000,0.300000,0.300000,15,14,1,true,1,1,60
ReactivePlayer,-35347,10,0.300000,0.300000,0.300000,36,29,7,true,1,7,57
ReactivePlayer,1000,10,0.300000,0.300000,0.300000,0,0,0,true,1,0,0
ReactivePlayer,-24270,10,0.300000,0.300000,0.300000,25,23,2,true,1,2,46
ReactivePlayer,-6027,10,0.300000,0.300000,0.300000,7,3,4,true,1,4,9
ReactivePlayer,-10330,10,0.300000,0.300000,0.300000,11,7,4,true,1,4,74
ReactivePlayer,-68,10,0.300000,0.300000,0.300000,1,0,1,true,1,1,21
ReactivePlayer,-78883,10,0.300000,0.300000,0.300000,78,70,8,true,1,8,97
ReactivePlayer,-2050,10,0.300000,0.300000,0.300000,3,0,3,true,1,3,30
ReactivePlayer,-9278,10,0.300000,0.300000,0.300000,10,8,2,true,1,2,61
ReactivePlayer,-4120,10,0.300000,0.300000,0.300000,5,2,3,true,1,3,26
ReactivePlayer,-10111,10,0.300000,0.300000,0.300000,11,10,1,true,1,1,45
ReactivePlayer,-56374,10,0.300000,0.300000,0.300000,56,50,6,true,1,6,91
ReactivePlayer,-45539,10,0.300000,0.300000,0.300000,46,40,6,true,1,6,73
ReactivePlayer,-3045,10,0.300000,0.300000,0.300000,4,3,1,true,1,1,9
ReactivePlayer,-100346,10,0.300000,0.300000,0.300000,99,92,7,false,0,7,91
ReactivePlayer,-18511,10,0.300000,0.300000,0.300000,19,16,3,true,1,3,73
ReactivePlayer,-38759,10,0.300000,0.300000,0.300000,39,31,8,true,1,8,95
ReactivePlayer,-23521,10,0.300000,0.300000,0.300000,24,20,4,true,1,4,73
ReactivePlayer,-82911,10,0.300000,0.300000,0.300000,83,75,8,true,1,8,82
ReactivePlayer,-14174,10,0.300000,0.300000,0.300000,15,12,3,true,1,3,30
ReactivePlayer,-33250,10,0.300000,0.300000,0.300000,34,30,4,true,1,4,50
ReactivePlayer,-27,10,0.300000,0.300000,0.300000,1,1,0,true,1,0,18
ReactivePlayer,-41401,10,0.300000,0.300000,0.300000,41,35,6,true,1,6,99
ReactivePlayer,-19319,10,0.300000,0.300000,0.300000,20,16,4,true,1,4,51
ReactivePlayer,-24,10,0.300000,0.300000,0.300000,1,0,1,true,1,1,5
ReactivePlayer,-3086,10,0.300000,0.300000,0.300000,4,3,1,true,1,1,30
ReactivePlayer,995,10,0.300000,0.300000,0.300000,0,0,0,true,1,0,4
ReactivePlayer,-13293,10,0.300000,0.300000,0.300000,14,13,1,true,1,1,40
ReactivePlayer,-23135,10,0.300000,0.300000,0.300000,24,23,1,true,1,1,21
ReactivePlayer,-2018,10,0.300000,0.300000,0.300000,3,2,1,true,1,1,11
ReactivePlayer,-15226,10,0.300000,0.300000,0.300000,16,12,4,true,1,4,48
ReactivePlayer,-53816,10,0.300000,0.300000,0.300000,54,49,5,true,1,5,70
ReactivePlayer,-15253,10,0.300000,0.300000,0.300000,16,11,5,true,1,5,35
ReactivePlayer,-22197,10,0.300000,0.300000,0.300000,23,15,8,true,1,8,59
ReactivePlayer,-15327,10,0.300000,0.300000,0.300000,16,11,5,true,1,5,69
ReactivePlayer,-4060,10,0.300000,0.300000,0.300000,5,3,2,true,1,2,25
ReactivePlayer,-16208,10,0.300000,0.300000,0.300000,17,11,6,true,1,6,68
ReactivePlayer,-10136,10,0.300000,0.300000,0.300000,11,8,3,true,1,3,42
ReactivePlayer,-12145,10,0.300000,0.300000,0.300000,13,12,1,true,1,1,37
ReactivePlayer,-100715,10,0.300000,0.300000,0.300000,100,97,3,false,0,3,58
ReactivePlayer,-8134,10,0.300000,0.300000,0.300000,9,6,3,true,1,3,45
ReactivePlayer,984,10,0.300000,0.300000,0.300000,0,0,0,true,1,0,2
ReactivePlayer,-1052,10,0.300000,0.300000,0.300000,2,1,1,true,1,1,16
ReactivePlayer,-13202,10,0.300000,0.300000,0.300000,14,13,1,true,1,1,32
ReactivePlayer,-100913,10,0.300000,0.300000,0.300000,100,96,4,false,0,4,68
ReactivePlayer,-27,10,0.300000,0.300000,0.300000,1,0,1,true,1,1,22
ReactivePlayer,-3110,10,0.300000,0.300000,0.300000,4,3,1,true,1,1,15
ReactivePlayer,-8832,10,0.300000,0.300000,0.300000,9,7,2,true,1,2,92
ReactivePlayer,-14395,10,0.300000,0.300000,0.300000,15,12,3,true,1,3,62
ReactivePlayer,-54881,10,0.300000,0.300000,0.300000,55,47,8,true,1,8,93
ReactivePlayer,-56651,10,0.300000,0.300000,0.300000,57,53,4,true,1,4,79
ReactivePlayer,-9073,10,0.300000,0.300000,0.300000,10,7,3,true,1,3,27
ReactivePlayer,-76410,10,0.300000,0.300000,0.300000,76,74,2,true,1,2,100
ReactivePlayer,-29353,10,0.300000,0.300000,0.300000,30,24,6,true,1,6,82
ReactivePlayer,-11295,10,0.300000,0.300000,0.300000,12,8,4,true,1,4,59
ReactivePlayer,-33923,10,0.300000,0.300000,0.300000,34,29,5,true,1,5,95
ReactivePlayer,-80029,10,0.300000,0.300000,0.300000,80,71,9,true,1,9,96
ReactivePlayer,973,10,0.300000,0.300000,0.300000,0,0,0,true,1,0,19
ReactivePlayer,-52431,10,0.300000,0.300000,0.300000,53,46,7,true,1,7,55
ReactivePlayer,-35355,10,0.300000,0.300000,0.300000,35,30,5,true,1,5,94
ReactivePlayer,-15384,10,0.300000,0.300000,0.300000,16,11,5,true,1,5,54
ReactivePlayer,-17304,10,0.300000,0.300000,0.300000,18,15,3,true,1,3,77
ReactivePlayer,-13263,10,0.300000,0.300000,0.300000,14,11,3,true,1,3,71
ReactivePlayer,-16258,10,0.300000,0.300000,0.300000,17,13,4,true,1,4,51
ReactivePlayer,-77770,10,0.300000,0.300000,0.300000,78,67,11,true,1,11,96
ReactivePlayer,-29419,10,0.300000,0.300000,0.300000,30,24,6,true,1,6,70
ReactivePlayer,-316,10,0.300000,0.300000,0.300000,1,0,1,true,1,1,12
ReactivePlayer,-34,10,0.300000,0.300000,0.300000,1,1,0,true,1,0,15
ReactivePlayer,-15188,10,0.300000,0.300000,0.300000,16,11,5,true,1,5,50
ReactivePlayer,-100128,10,0.300000,0.300000,0.300000,99,90,9,false,0,9,91
ReactivePlayer,-6033,10,0.300000,0.300000,0.300000,7,7,0,true,1,0,12
ReactivePlayer,-3126,10,0.300000,0.300000,0.300000,4,3,1,true,1,1,33
ReactivePlayer,-100415,10,0.300000,0.300000,0.300000,99,92,7,false,0,7,92
ReactivePlayer,-35512,10,0.300000,0.300000,0.300000,36,30,6,true,1,6,54
ReactivePlayer,-13835,10,0.300000,0.300000,0.300000,14,7,7,true,1,7,96
ReactivePlayer,-17188,10,0.300000,0.300000,0.300000,18,14,4,true,1,4,55
ReactivePlayer,-29393,10,0.300000,0.300000,0.300000,30,26,4,true,1,4,69
ReactivePlayer,-100545,10,0.300000,0.300000,0.300000,99,96,3,false,0,3,89
ReactivePlayer,-75154,10,0.300000,0.300000,0.300000,75,67,8,true,1,8,94
ReactivePlayer,-38869,10,0.300000,0.300000,0.300000,39,30,9,true,1,9,87
ReactivePlayer,-2017,10,0.300000,0.300000,0.300000,3,2,1,true,1,1,9
ReactivePlayer,-4055,10,0.300000,0.300000,0.300000,5,3,2,true,1,2,13
ReactivePlayer,-13451,10,0.300000,0.300000,0.300000,14,11,3,true,1,3,58
ReactivePlayer,-100779,10,0.300000,0.300000,0.300000,100,98,2,false,0,2,41
ReactivePlayer,-47075,10,0.300000,0.300000,0.300000,47,40,7,true,1,7,88
ReactivePlayer,-3229,10,0.300000,0.300000,0.300000,4,1,3,true,1,3,57
ReactivePlayer,-45211,10,0.300000,0.300000,0.300000,45,40,5,true,1,5,94
ReactivePlayer,-100141,10,0.300000,0.300000,0.300000,99,92,7,false,0,7,83
ReactivePlayer,-30356,10,0.300000,0.300000,0.300000,31,29,2,true,1,2,53
ReactivePlayer,-100068,10,0.300000,0.300000,0.300000,99,94,5,false,0,5,86
ReactivePlayer,-4087,10,0.300000,0.300000,0.300000,5,4,1,true,1,1,38
ReactivePlayer,-100091,10,0.300000,0.300000,0.300000,99,96,3,false,0,3,93
ReactivePlayer,-53385,10,0.300000,0.300000,0.300000,54,53,1,true,1,1,27
ReactivePlayer,-4168,10,0.300000,0.300000,0.300000,5,0,5,true,1,5,42
ReactivePlayer,-60231,10,0.300000,0.300000,0.300000,60,54,6,true,1,6,93
ReactivePlayer,-56921,10,0.300000,0.300000,0.300000,57,46,11,true,1,11,95
ReactivePlayer,-6097,10,0.300000,0.300000,0.300000,7,4,3,true,1,3,39
ReactivePlayer,-5188,10,0.300000,0.300000,0.300000,6,3,3,true,1,3,56
ReactivePlayer,-38431,10,0.300000,0.300000,0.300000,39,32,7,true,1,7,84
ReactivePlayer,-4059,10,0.300000,0.300000,0.300000,5,5,0,true,1,0,15
ReactivePlayer,-1075,10,0.300000,0.300000,0.300000,2,0,2,true,1,2,39
ReactivePlayer,-8272,10,0.300000,0.300000,0.300000,9,2,7,true,1,7,63
ReactivePlayer,-12171,10,0.300000,0.300000,0.300000,13,11,2,true,1,2,33
ReactivePlayer,-35330,10,0.300000,0.300000,0.300000,36,33,3,true,1,3,55
ReactivePlayer,-100620,10,0.300000,0.300000,0.300000,99,96,3,false,0,3,82
ReactivePlayer,-52590,10,0.300000,0.300000,0.300000,53,48,5,true,1,5,68
ReactivePlayer,-17223,10,0.300000,0.300000,0.300000,18,13,5,true,1,5,56
ReactivePlayer,-11133,10,0.300000,0.300000,0.300000,12,8,4,true,1,4,33
ReactivePlayer,999,10,0.300000,0.300000,0.300000,0,0,0,true,1,0,1
ReactivePlayer,-5081,10,0.300000,0.300000,0.300000,6,5,1,true,1,1,28
ReactivePlayer,-13351,10,0.300000,0.300000,0.300000,14,9,5,true,1,5,66
ReactivePlayer,-100969,10,0.300000,0.300000,0.300000,99,87,12,false,0,12,95
ReactivePlayer,-6036,10,0.300000,0.300000,0.300000,7,6,1,true,1,1,13
ReactivePlayer,-17225,10,0.300000,0.300000,0.300000,18,12,6,true,1,6,64
ReactivePlayer,-5092,10,0.300000,0.300000,0.300000,6,6,0,true,1,0,36
ReactivePlayer,-50867,10,0.300000,0.300000,0.300000,51,44,7,true,1,7,92
ReactivePlayer,-25119,10,0.300000,0.300000,0.300000,26,25,1,true,1,1,22
ReactivePlayer,-4059,10,0.300000,0.300000,0.300000,5,4,1,true,1,1,22
ReactivePlayer,-100259,10,0.300000,0.300000,0.300000,99,92,7,false,0,7,81
ReactivePlayer,-20301,10,0.300000,0.300000,0.300000,21,17,4,true,1,4,59
ReactivePlayer,-1098,10,0.300000,0.300000,0.300000,2,0,2,true,1,2,39
ReactivePlayer,-35292,10,0.300000,0.300000,0.300000,36,27,9,true,1,9,66
ReactivePlayer,-19163,10,0.300000,0.300000,0.300000,20,17,3,true,1,3,26
ReactivePlayer,-100001,10,0.300000,0.300000,0.300000,99,91,8,false,0,8,91
ReactivePlayer,-56110,10,0.300000,0.300000,0.300000,56,51,5,true,1,5,100
ReactivePlayer,-69984,10,0.300000,0.300000,0.300000,70,64,6,true,1,6,98
ReactivePlayer,-89554,10,0.300000,0.300000,0.300000,90,85,5,true,1,5,91
ReactivePlayer,-100117,10,0.300000,0.300000,0.300000,99,93,6,false,0,6,95
ReactivePlayer,-3069,10,0.300000,0.300000,0.300000,4,1,3,true,1,3,19
ReactivePlayer,-55455,10,0.300000,0.300000,0.300000,56,52,4,true,1,4,71
ReactivePlayer,-9073,10,0.300000,0.300000,0.300000,10,9,1,true,1,1,22
ReactivePlayer,-38693,10,0.300000,0.300000,0.300000,39,35,4,true,1,4,65
ReactivePlayer,-91271,10,0.300000,0.300000,0.300000,91,83,8,true,1,8,83
ReactivePlayer,-4030,10,0.300000,0.300000,0.300000,5,2,3,true,1,3,19
ReactivePlayer,-42549,10,0.300000,0.300000,0.300000,43,37,6,true,1,6,83
ReactivePlayer,-73527,10,0.300000,0.300000,0.300000,73,65,8,true,1,8,95
ReactivePlayer,-90546,10,0.300000,0.300000,0.300000,91,85,6,true,1,6,84
ReactivePlayer,-16171,10,0.300000,0.300000,0.300000,17,17,0,true,1,0,41
ReactivePlayer,-38682,10,0.300000,0.300000,0.300000,39,37,2,true,1,2,67
ReactivePlayer,-44381,10,0.300000,0.300000,0.300000,45,38,7,true,1,7,75
ReactivePlayer,-3068,10,0.300000,0.300000,0.300000,4,2,2,true,1,2,28
ReactivePlayer,-11128,10,0.300000,0.300000,0.300000,12,8,4,true,1,4,60
ReactivePlayer,-38411,10,0.300000,0.300000,0.300000,39,35,4,true,1,4,65
ReactivePlayer,-100505,10,0.300000,0.300000,0.300000,98,91,7,false,0,7,87
ReactivePlayer,-53,10,0.300000,0.300000,0.300000,1,0,1,true,1,1,24
ReactivePlayer,-9247,10,0.300000,0.300000,0.300000,10,4,6,true,1,6,49
ReactivePlayer,-84404,10,0.300000,0.300000,0.300000,84,76,8,true,1,8,100
ReactivePlayer,-11333,10,0.300000,0.300000,0.300000,12,9,3,true,1,3,61
ReactivePlayer,-34598,10,0.300000,0.300000,0.300000,35,28,7,true,1,7,83
ReactivePlayer,-3120,10,0.300000,0.300000,0.300000,4,2,2,true,1,2,26
ReactivePlayer,-1042,10,0.300000,0.300000,0.300000,2,1,1,true,1,1,22
ReactivePlayer,-100535,10,0.300000,0.300000,0.300000,99,94,5,false,0,5,88
ReactivePlayer,-10468,10,0.300000,0.300000,0.300000,11,10,1,true,1,1,70
ReactivePlayer,-29572,10,0.300000,0.300000,0.300000,30,23,7,true,1,7,79
ReactivePlayer,-2,10,0.300000,0.300000,0.300000,1,1,0,true,1,0,2
ReactivePlayer,-30644,10,0.300000,0.300000,0.300000,31,26,5,true,1,5,76
ReactivePlayer,-40657,10,0.300000,0.300000,0.300000,41,37,4,true,1,4,84
ReactivePlayer,-28810,10,0.300000,0.300000,0.300000,29,21,8,true,1,8,95
ReactivePlayer,-54837,10,0.300000,0.300000,0.300000,55,47,8,true,1,8,89
ReactivePlayer,-32691,10,0.300000,0.300000,0.300000,33,28,5,true,1,5,69
ReactivePlayer,-56835,10,0.300000,0.300000,0.300000,57,46,11,true,1,11,97
ReactivePlayer,-28957,10,0.300000,0.300000,0.300000,29,26,3,true,1,3,69
ReactivePlayer,-89923,10,0.300000,0.300000,0.300000,90,81,9,true,1,9,95
ReactivePlayer,-74172,10,0.300000,0.300000,0.300000,73,61,12,true,1,12,100
ReactivePlayer,-128,10,0.300000,0.300000,0.300000,1,0,1,true,1,1,23
ReactivePlayer,-13277,10,0.300000,0.300000,0.300000,14,11,3,true,1,3,55
ReactivePlayer,-48509,10,0.300000,0.300000,0.300000,49,42,7,true,1,7,70
ReactivePlayer,-5079,10,0.300000,0.300000,0.300000,6,4,2,true,1,2,31
ReactivePlayer,-100365,10,0.300000,0.300000,0.300000,99,91,8,false,0,8,89
ReactivePlayer,-44,10,0.300000,0.300000,0.300000,1,0,1,true,1,1,17
ReactivePlayer,-3151,10,0.300000,0.300000,0.300000,4,2,2,true,1,2,26
ReactivePlayer,-48125,10,0.300000,0.300000,0.300000,48,40,8,true,1,8,94
ReactivePlayer,-11226,10,0.300000,0.300000,0.300000,12,7,5,true,1,5,54
ReactivePlayer,-100950,10,0.300000,0.300000,0.300000,99,98,1,false,0,1,16
ReactivePlayer,-49506,10,0.300000,0.300000,0.300000,50,44,6,true,1,6,45
ReactivePlayer,-21641,10,0.300000,0.300000,0.300000,22,20,2,true,1,2,83
ReactivePlayer,-20295,10,0.300000,0.300000,0.300000,21,15,6,true,1,6,59
ReactivePlayer,-20559,10,0.300000,0.300000,0.300000,21,16,5,true,1,5,82
ReactivePlayer,-30236,10,0.300000,0.300000,0.300000,31,30,1,true,1,1,42
ReactivePlayer,-6183,10,0.300000,0.300000,0.300000,7,2,5,true,1,5,50
ReactivePlayer,-4057,10,0.300000,0.300000,0.300000,5,2,3,true,1,3,28
ReactivePlayer,-7,10,0.300000,0.300000,0.300000,1,1,0,true,1,0,5
ReactivePlayer,-4065,10,0.300000,0.300000,0.300000,5,4,1,true,1,1,29
ReactivePlayer,-6152,10,0.300000,0.300000,0.300000,7,5,2,true,1,2,45
ReactivePlayer,-100762,10,0.300000,0.300000,0.300000,100,97,3,false,0,3,77
ReactivePlayer,-24612,10,0.300000,0.300000,0.300000,25,21,4,true,1,4,69
ReactivePlayer,999,10,0.300000,0.300000,0.300000,0,0,0,true,1,0,1
ReactivePlayer,-7095,10,0.300000,0.300000,0.300000,8,5,3,true,1,3,42
ReactivePlayer,-94036,10,0.300000,0.300000,0.300000,94,88,6,true,1,6,95
ReactivePlayer,-19565,10,0.300000,0.300000,0.300000,20,15,5,true,1,5,83
ReactivePlayer,-4010,10,0.300000,0.300000,0.300000,5,5,0,true,1,0,6
ReactivePlayer,-100356,10,0.300000,0.300000,0.300000,99,86,13,false,0,13,99
ReactivePlayer,-35860,10,0.300000,0.300000,0.300000,36,26,10,true,1,10,89
ReactivePlayer,-7177,10,0.300000,0.300000,0.300000,8,4,4,true,1,4,35
ReactivePlayer,-7061,10,0.300000,0.300000,0.300000,8,6,2,true,1,2,21
ReactivePlayer,-11117,10,0.300000,0.300000,0.300000,12,9,3,true,1,3,32
ReactivePlayer,-85314,10,0.300000,0.300000,0.300000,85,77,8,true,1,8,99
ReactivePlayer,-8313,10,0.300000,0.300000,0.300000,9,5,4,true,1,4,55
ReactivePlayer,-67204,10,0.300000,0.300000,0.300000,67,64,3,true,1,3,91
ReactivePlayer,-100841,10,0.300000,0.300000,0.300000,98,92,6,false,0,6,95
ReactivePlayer,-100900,10,0.300000,0.300000,0.300000,98,94,4,false,0,4,87
ReactivePlayer,-9218,10,0.300000,0.300000,0.300000,10,8,2,true,1,2,43
ReactivePlayer,-37070,10,0.300000,0.300000,0.300000,37,31,6,true,1,6,93
ReactivePlayer,-42445,10,0.300000,0.300000,0.300000,43,40,3,true,1,3,63
ReactivePlayer,-21255,10,0.300000,0.300000,0.300000,22,18,4,true,1,4,36
ReactivePlayer,-28409,10,0.300000,0.300000,0.300000,29,24,5,true,1,5,72
ReactivePlayer,-48615,10,0.300000,0.300000,0.300000,49,40,9,true,1,9,88
ReactivePlayer,-8119,10,0.300000,0.300000,0.300000,9,6,3,true,1,3,41
ReactivePlayer,-3059,10,0.300000,0.300000,0.300000,4,2,2,true,1,2,31
ReactivePlayer,-7,10,0.300000,0.300000,0.300000,1,0,1,true,1,1,6
ReactivePlayer,-1038,10,0.300000,0.300000,0.300000,2,2,0,true,1,0,13
ReactivePlayer,-53700,10,0.300000,0.300000,0.300000,54,46,8,true,1,8,89
ReactivePlayer,-91114,10,0.300000,0.300000,0.300000,91,86,5,true,1,5,90
ReactivePlayer,-100000,10,0.300000,0.300000,0.300000,99,95,4,false,0,4,84
ReactivePlayer,-5139,10,0.300000,0.300000,0.300000,6,4,2,true,1,2,38
ReactivePlayer,-45607,10,0.300000,0.300000,0.300000,46,43,3,true,1,3,65
ReactivePlayer,-78534,10,0.300000,0.300000,0.300000,78,71,7,true,1,7,99
ReactivePlayer,-8345,10,0.300000,0.300000,0.300000,9,5,4,true,1,4,53
ReactivePlayer,-9074,10,0.300000,0.300000,0.300000,10,8,2,true,1,2,24
ReactivePlayer,-54877,10,0.300000,0.300000,0.300000,55,43,12,true,1,12,83
ReactivePlayer,-19271,10,0.300000,0.300000,0.300000,20,14,6,true,1,6,67
ReactivePlayer,-1012,10,0.300000,0.300000,0.300000,2,2,0,true,1,0,8
ReactivePlayer,-43166,10,0.300000,0.300000,0.300000,43,38,5,true,1,5,97
ReactivePlayer,-20605,10,0.300000,0.300000,0.300000,21,13,8,true,1,8,82
ReactivePlayer,-73527,10,0.300000,0.300000,0.300000,73,70,3,true,1,3,98
ReactivePlayer,-28475,10,0.300000,0.300000,0.300000,29,24,5,true,1,5,78
ReactivePlayer,-3043,10,0.300000,0.300000,0.300000,4,1,3,true,1,3,24
ReactivePlayer,-100830,10,0.300000,0.300000,0.300000,99,96,3,false,0,3,97
ReactivePlayer,-13117,10,0.300000,0.300000,0.300000,14,7,7,true,1,7,59
ReactivePlayer,-10288,10,0.300000,0.300000,0.300000,11,9,2,true,1,2,51
ReactivePlayer,-42628,10,0.300000,0.300000,0.300000,43,39,4,true,1,4,78
ReactivePlayer,-27358,10,0.300000,0.300000,0.300000,28,24,4,true,1,4,75
ReactivePlayer,-6082,10,0.300000,0.300000,0.300000,7,5,2,true,1,2,41
ReactivePlayer,-15116,10,0.300000,0.300000,0.300000,16,13,3,true,1,3,19
ReactivePlayer,-52713,10,0.300000,0.300000,0.300000,53,46,7,true,1,7,95
ReactivePlayer,-24369,10,0.300000,0.300000,0.300000,25,17,8,true,1,8,88
ReactivePlayer,-4071,10,0.300000,0.300000,0.300000,5,4,1,true,1,1,26
ReactivePlayer,-19312,10,0.300000,0.300000,0.300000,20,14,6,true,1,6,71
ReactivePlayer,-3017,10,0.300000,0.300000,0.300000,4,2,2,true,1,2,11
ReactivePlayer,-7251,10,0.300000,0.300000,0.300000,8,4,4,true,1,4,57
ReactivePlayer,-22,10,0.300000,0.300000,0.300000,1,0,1,true,1,1,9
ReactivePlayer,-11140,10,0.300000,0.300000,0.300000,12,8,4,true,1,4,51
ReactivePlayer,-34931,10,0.300000,0.300000,0.300000,35,23,12,true,1,12,88
ReactivePlayer,-13396,10,0.300000,0.300000,0.300000,14,11,3,true,1,3,58
ReactivePlayer,-100524,10,0.300000,0.300000,0.300000,100,95,5,false,0,5,59
ReactivePlayer,-33304,10,0.300000,0.300000,0.300000,34,25,9,true,1,9,65
ReactivePlayer,-33704,10,0.300000,0.300000,0.300000,34,22,12,true,1,12,87
ReactivePlayer,-10170,10,0.300000,0.300000,0.300000,11,10,1,true,1,1,34
ReactivePlayer,-43067,10,0.300000,0.300000,0.300000,43,36,7,true,1,7,98
ReactivePlayer,-98776,10,0.300000,0.300000,0.300000,99,95,4,true,1,4,84
ReactivePlayer,-10078,10,0.300000,0.300000,0.300000,11,6,5,true,1,5,33
ReactivePlayer,-4101,10,0.300000,0.300000,0.300000,5,4,1,true,1,1,36
ReactivePlayer,-7061,10,0.300000,0.300000,0.300000,8,7,1,true,1,1,31
ReactivePlayer,-100425,10,0.300000,0.300000,0.300000,99,93,6,false,0,6,88
ReactivePlayer,-63899,10,0.300000,0.300000,0.300000,64,57,7,true,1,7,92
ReactivePlayer,-4220,10,0.300000,0.300000,0.300000,5,3,2,true,1,2,55
ReactivePlayer,-35610,10,0.300000,0.300000,0.300000,35,33,2,true,1,2,98
ReactivePlayer,-46854,10,0.300000,0.300000,0.300000,47,42,5,true,1,5,93
ReactivePlayer,-8179,10,0.300000,0.300000,0.300000,9,8,1,true,1,1,35
ReactivePlayer,995,10,0.300000,0.300000,0.300000,0,0,0,true,1,0,4
ReactivePlayer,-47381,10,0.300000,0.300000,0.300000,47,35,12,true,1,12,100
ReactivePlayer,-29695,10,0.300000,0.300000,0.300000,30,26,4,true,1,4,80
ReactivePlayer,-39375,10,0.300000,0.300000,0.300000,40,35,5,true,1,5,65
ReactivePlayer,-9084,10,0.300000,0.300000,0.300000,10,4,6,true,1,6,47
ReactivePlayer,-1045,10,0.300000,0.300000,0.300000,2,1,1,true,1,1,14
ReactivePlayer,-13162,10,0.300000,0.300000,0.300000,14,14,0,true,1,0,31
ReactivePlayer,-13383,10,0.300000,0.300000,0.300000,14,14,0,true,1,0,67
ReactivePlayer,998,10,0.300000,0.300000,0.300000,0,0,0,true,1,0,2
ReactivePlayer,-12308,10,0.300000,0.300000,0.300000,13,7,6,true,1,6,57
ReactivePlayer,-4037,10,0.300000,0.300000,0.300000,5,3,2,true,1,2,19
ReactivePlayer,-29578,10,0.300000,0.300000,0.300000,30,21,9,true,1,9,93
ReactivePlayer,-14264,10,0.300000,0.300000,0.300000,15,13,2,true,1,2,53
ReactivePlayer,-69237,10,0.300000,0.300000,0.300000,69,59,10,true,1,10,97
ReactivePlayer,-32457,10,0.300000,0.300000,0.300000,33,26,7,true,1,7,88
ReactivePlayer,-42260,10,0.300000,0.300000,0.300000,43,38,5,true,1,5,56
ReactivePlayer,-60872,10,0.300000,0.300000,0.300000,61,50,11,true,1,11,98
ReactivePlayer,-1012,10,0.300000,0.300000,0.300000,2,0,2,true,1,2,11
ReactivePlayer,-12087,10,0.300000,0.300000,0.300000,13,8,5,true,1,5,27
ReactivePlayer,-41855,10,0.300000,0.300000,0.300000,42,32,10,true,1,10,77
ReactivePlayer,-100062,10,0.300000,0.300000,0.300000,99,93,6,false,0,6,89
ReactivePlayer,-37579,10,0.300000,0.300000,0.300000,38,25,13,true,1,13,80
ReactivePlayer,-100673,10,0.300000,0.300000,0.300000,99,90,9,false,0,9,91
ReactivePlayer,-100187,10,0.300000,0.300000,0.300000,99,94,5,false,0,5,96
ReactivePlayer,-12102,10,0.300000,0.300000,0.300000,13,11,2,true,1,2,35
ReactivePlayer,-61261,10,0.300000,0.300000,0.300000,61,51,10,true,1,10,96
ReactivePlayer,-47796,10,0.300000,0.300000,0.300000,48,42,6,true,1,6,87
ReactivePlayer,-1008,10,0.300000,0.300000,0.300000,2,0,2,true,1,2,7
ReactivePlayer,-1045,10,0.300000,0.300000,0.300000,2,2,0,true,1,0,21
ReactivePlayer,-2101,10,0.300000,0.300000,0.300000,3,2,1,true,1,1,18
ReactivePlayer,-5072,10,0.300000,0.300000,0.300000,6,6,0,true,1,0,10
ReactivePlayer,-61579,10,0.300000,0.300000,0.300000,62,60,2,true,1,2,78
ReactivePlayer,-30483,10,0.300000,0.300000,0.300000,31,24,7,true,1,7,63
ReactivePlayer,-13176,10,0.300000,0.300000,0.300000,14,6,8,true,1,8,63
ReactivePlayer,-70917,10,0.300000,0.300000,0.300000,71,67,4,true,1,4,72
ReactivePlayer,-3082,10,0.300000,0.300000,0.300000,4,1,3,true,1,3,35
ReactivePlayer,-18358,10,0.300000,0.300000,0.300000,19,13,6,true,1,6,84
ReactivePlayer,-48533,10,0.300000,0.300000,0.300000,49,43,6,true,1,6,73
ReactivePlayer,-20128,10,0.300000,0.300000,0.300000,21,17,4,true,1,4,32
ReactivePlayer,-66004,10,0.300000,0.300000,0.300000,66,60,6,true,1,6,74
ReactivePlayer,-100824,10,0.300000,0.300000,0.300000,99,93,6,false,0,6,95
ReactivePlayer,-100715,10,0.300000,0.300000,0.300000,100,93,7,false,0,7,78
ReactivePlayer,-26455,10,0.300000,0.300000,0.300000,27,23,4,true,1,4,70
ReactivePlayer,-13453,10,0.300000,0.300000,0.300000,14,8,6,true,1,6,88
ReactivePlayer,-57752,10,0.300000,0.300000,0.300000,57,48,9,true,1,9,94
ReactivePlayer,-18220,10,0.300000,0.300000,0.300000,19,18,1,true,1,1,23
ReactivePlayer,-12122,10,0.300000,0.300000,0.300000,13,10,3,true,1,3,31
ReactivePlayer,-100833,10,0.300000,0.300000,0.300000,100,94,6,false,0,6,71
ReactivePlayer,901,10,0.300000,0.300000,0.300000,0,0,0,true,1,0,26
ReactivePlayer,-24564,10,0.300000,0.300000,0.300000,25,19,6,true,1,6,89
ReactivePlayer,-27506,10,0.300000,0.300000,0.300000,28,25,3,true,1,3,66
ReactivePlayer,-44630,10,0.300000,0.300000,0.300000,45,38,7,true,1,7,82
ReactivePlayer,-6035,10,0.300000,0.300000,0.300000,7,4,3,true,1,3,18
ReactivePlayer,-114,10,0.300000,0.300000,0.300000,1,1,0,true,1,0,35
ReactivePlayer,-2046,10,0.300000,0.300000,0.300000,3,3,0,true,1,0,14
ReactivePlayer,-17234,10,0.300000,0.300000,0.300000,18,9,9,true,1,9,43
ReactivePlayer,-52150,10,0.300000,0.300000,0.300000,52,43,9,true,1,9,89
ReactivePlayer,-24545,10,0.300000,0.300000,0.300000,25,16,9,true,1,9,81
ReactivePlayer,-68660,10,0.300000,0.300000,0.300000,69,67,2,true,1,2,81
ReactivePlayer,-100762,10,0.300000,0.300000,0.300000,100,100,0,false,0,0,3
ReactivePlayer,-53001,10,0.300000,0.300000,0.300000,52,43,9,true,1,9,98
ReactivePlayer,1000,10,0.300000,0.300000,0.300000,0,0,0,true,1,0,0
ReactivePlayer,-19535,10,0.300000,0.300000,0.300000,20,13,7,true,1,7,80
ReactivePlayer,-12323,10,0.300000,0.300000,0.300000,13,8,5,true,1,5,57
ReactivePlayer,-14250,10,0.300000,0.300000,0.300000,15,9,6,true,1,6,51
ReactivePlayer,966,10,0.300000,0.300000,0.300000,0,0,0,true,1,0,11
ReactivePlayer,-32428,10,0.300000,0.300000,0.300000,33,25,8,true,1,8,60
ReactivePlayer,-1219,10,0.300000,0.300000,0.300000,2,1,1,true,1,1,31
ReactivePlayer,-19168,10,0.300000,0.300000,0.300000,20,15,5,true,1,5,48
ReactivePlayer,-33889,10,0.300000,0.300000,0.300000,34,29,5,true,1,5,82
ReactivePlayer,-59977,10,0.300000,0.300000,0.300000,60,51,9,true,1,9,94
ReactivePlayer,-14171,10,0.300000,0.300000,0.300000,15,9,6,true,1,6,38
ReactivePlayer,-10297,10,0.300000,0.300000,0.300000,11,3,8,true,1,8,59
ReactivePlayer,-50140,10,0.300000,0.300000,0.300000,50,44,6,true,1,6,98
ReactivePlayer,-20126,10,0.300000,0.300000,0.300000,21,19,2,true,1,2,29
ReactivePlayer,-7139,10,0.300000,0.300000,0.300000,8,3,5,true,1,5,58
ReactivePlayer,-1015,10,0.300000,0.300000,0.300000,2,1,1,true,1,1,10
ReactivePlayer,-29604,10,0.300000,0.300000,0.300000,30,24,6,true,1,6,70
ReactivePlayer,-100229,10,0.300000,0.300000,0.300000,99,93,6,false,0,6,86
ReactivePlayer,-100388,10,0.300000,0.300000,0.300000,99,93,6,false,0,6,93
ReactivePlayer,-100330,10,0.300000,0.300000,0.300000,99,95,4,false,0,4,82
ReactivePlayer,-8075,10,0.300000,0.300000,0.300000,9,2,7,true,1,7,37
ReactivePlayer,-33530,10,0.300000,0.300000,0.300000,34,26,8,true,1,8,64
ReactivePlayer,-1027,10,0.300000,0.300000,0.300000,2,1,1,true,1,1,15
ReactivePlayer,-11189,10,0.300000,0.300000,0.300000,12,10,2,true,1,2,47
ReactivePlayer,-17108,10,0.300000,0.300000,0.300000,18,16,2,true,1,2,26
ReactivePlayer,-85441,10,0.300000,0.300000,0.300000,85,75,10,true,1,10,100
ReactivePlayer,-12151,10,0.300000,0.300000,0.300000,13,8,5,true,1,5,64
ReactivePlayer,-59821,10,0.300000,0.300000,0.300000,60,54,6,true,1,6,84
ReactivePlayer,-10,10,0.300000,0.300000,0.300000,1,1,0,true,1,0,5
ReactivePlayer,-100678,10,0.300000,0.300000,0.300000,100,97,3,false,0,3,49
ReactivePlayer,-52917,10,0.300000,0.300000,0.300000,53,44,9,true,1,9,90
ReactivePlayer,-38435,10,0.300000,0.300000,0.300000,39,37,2,true,1,2,80
ReactivePlayer,-18567,10,0.300000,0.300000,0.300000,19,15,4,true,1,4,60
ReactivePlayer,-27326,10,0.300000,0.300000,0.300000,28,24,4,true,1,4,65
ReactivePlayer,-100265,10,0.300000,0.300000,0.300000,99,99,0,false,0,0,73
ReactivePlayer,-7298,10,0.300000,0.300000,0.300000,8,5,3,true,1,3,56
ReactivePlayer,-14145,10,0.300000,0.300000,0.300000,15,15,0,true,1,0,48
ReactivePlayer,978,10,0.300000,0.300000,0.300000,0,0,0,true,1,0,5
ReactivePlayer,-3124,10,0.300000,0.300000,0.300000,4,3,1,true,1,1,23
ReactivePlayer,-5,10,0.300000,0.300000,0.300000,1,1,0,true,1,0,5
ReactivePlayer,-100602,10,0.300000,0.300000,0.300000,100,96,4,false,0,4,78
ReactivePlayer,-17236,10,0.300000,0.300000,0.300000,18,10,8,true,1,8,54
ReactivePlayer,-5065,10,0.300000,0.300000,0.300000,6,5,1,true,1,1,14
ReactivePlayer,-24293,10,0.300000,0.300000,0.300000,25,23,2,true,1,2,43
ReactivePlayer,-27416,10,0.300000,0.300000,0.300000,28,24,4,true,1,4,59
ReactivePlayer,-2052,10,0.300000,0.300000,0.300000,3,3,0,true,1,0,14
ReactivePlayer,-5109,10,0.300000,0.300000,0.300000,6,4,2,true,1,2,36
ReactivePlayer,926,10,0.300000,0.300000,0.300000,0,0,0,true,1,0,10
ReactivePlayer,-46793,10,0.300000,0.300000,0.300000,47,36,11,true,1,11,90
ReactivePlayer,-6094,10,0.300000,0.300000,0.300000,7,7,0,true,1,0,30
ReactivePlayer,-68855,10,0.300000,0.300000,0.300000,68,63,5,true,1,5,94
ReactivePlayer,-21244,10,0.300000,0.300000,0.300000,22,16,6,true,1,6,50
ReactivePlayer,-19802,10,0.300000,0.300000,0.300000,20,12,8,true,1,8,72
ReactivePlayer,-1040,10,0.300000,0.300000,0.300000,2,1,1,true,1,1,25
ReactivePlayer,-88171,10,0.300000,0.300000,0.300000,88,80,8,true,1,8,97
ReactivePlayer,-100494,10,0.300000,0.300000,0.300000,98,94,4,false,0,4,100
ReactivePlayer,-100301,10,0.300000,0.300000,0.300000,99,96,3,false,0,3,73
ReactivePlayer,-100030,10,0.300000,0.300000,0.300000,99,91,8,false,0,8,92
ReactivePlayer,-43293,10,0.300000,0.300000,0.300000,43,37,6,true,1,6,90
ReactivePlayer,-21257,10,0.300000,0.300000,0.300000,22,15,7,true,1,7,66
ReactivePlayer,-27598,10,0.300000,0.300000,0.300000,28,24,4,true,1,4,74
ReactivePlayer,-27324,10,0.300000,0.300000,0.300000,28,25,3,true,1,3,53
ReactivePlayer,-27568,10,0.300000,0.300000,0.300000,28,22,6,true,1,6,83
ReactivePlayer,-26246,10,0.300000,0.300000,0.300000,27,27,0,true,1,0,58
ReactivePlayer,-26489,10,0.300000,0.300000,0.300000,27,25,2,true,1,2,48
ReactivePlayer,-53068,10,0.300000,0.300000,0.300000,53,42,11,true,1,11,86
ReactivePlayer,-97219,10,0.300000,0.300000,0.300000,97,92,5,true,1,5,95
ReactivePlayer,-27,10,0.300000,0.300000,0.300000,1,0,1,true,1,1,11
ReactivePlayer,-7297,10,0.300000,0.300000,0.300000,8,5,3,true,1,3,76
ReactivePlayer,-100287,10,0.300000,0.300000,0.300000,99,98,1,false,0,1,56
ReactivePlayer,-11159,10,0.300000,0.300000,0.300000,12,7,5,true,1,5,47
ReactivePlayer,-100475,10,0.300000,0.300000,0.300000,98,93,5,false,0,5,100
ReactivePlayer,-30393,10,0.300000,0.300000,0.300000,31,23,8,true,1,8,68
ReactivePlayer,-10127,10,0.300000,0.300000,0.300000,11,8,3,true,1,3,40
ReactivePlayer,-28244,10,0.300000,0.300000,0.300000,29,21,8,true,1,8,67
ReactivePlayer,-17339,10,0.300000,0.300000,0.300000,18,13,5,true,1,5,75
ReactivePlayer,-33417,10,0.300000,0.300000,0.300000,34,30,4,true,1,4,72
ReactivePlayer,-6306,10,0.300000,0.300000,0.300000,7,0,7,true,1,7,42
ReactivePlayer,996,10,0.300000,0.300000,0.300000,0,0,0,true,1,0,4
ReactivePlayer,-100984,10,0.300000,0.300000,0.300000,99,95,4,false,0,4,98
ReactivePlayer,-85662,10,0.300000,0.300000,0.300000,86,82,4,true,1,4,75
ReactivePlayer,-57155,10,0.300000,0.300000,0.300000,57,47,10,true,1,10,95
ReactivePlayer,-83762,10,0.300000,0.300000,0.300000,84,81,3,true,1,3,95
ReactivePlayer,-6076,10,0.300000,0.300000,0.300000,7,5,2,true,1,2,24
ReactivePlayer,-20172,10,0.300000,0.300000,0.300000,21,19,2,true,1,2,49
ReactivePlayer,-32396,10,0.300000,0.300000,0.300000,33,28,5,true,1,5,65
ReactivePlayer,-14288,10,0.300000,0.300000,0.300000,15,12,3,true,1,3,45
ReactivePlayer,-100948,10,0.300000,0.300000,0.300000,100,93,7,false,0,7,79
ReactivePlayer,-9154,10,0.300000,0.300000,0.300000,10,6,4,true,1,4,57
ReactivePlayer,-12227,10,0.300000,0.300000,0.300000,13,8,5,true,1,5,57
ReactivePlayer,-6064,10,0.300000,0.300000,0.300000,7,6,1,true,1,1,23
ReactivePlayer,-5068,10,0.300000,0.300000,0.300000,6,3,3,true,1,3,26
ReactivePlayer,-63851,10,0.300000,0.300000,0.300000,64,57,7,true,1,7,90
ReactivePlayer,-18266,10,0.300000,0.300000,0.300000,19,19,0,true,1,0,24
ReactivePlayer,-14262,10,0.300000,0.300000,0.300000,15,9,6,true,1,6,73
ReactivePlayer,-5051,10,0.300000,0.300000,0.300000,6,5,1,true,1,1,20
ReactivePlayer,-14093,10,0.300000,0.300000,0.300000,15,13,2,true,1,2,20
ReactivePlayer,-100111,10,0.300000,0.300000,0.300000,98,91,7,false,0,7,97
ReactivePlayer,-21130,10,0.300000,0.300000,0.300000,22,15,7,true,1,7,53
ReactivePlayer,-37533,10,0.300000,0.300000,0.300000,38,33,5,true,1,5,63
ReactivePlayer,999,10,0.300000,0.300000,0.300000,0,0,0,true,1,0,1
ReactivePlayer,-35349,10,0.300000,0.300000,0.300000,36,28,8,true,1,8,55
ReactivePlayer,-23240,10,0.300000,0.300000,0.300000,24,17,7,true,1,7,50
ReactivePlayer,-2046,10,0.300000,0.300000,0.300000,3,1,2,true,1,2,15
ReactivePlayer,-19360,10,0.300000,0.300000,0.300000,20,19,1,true,1,1,84
ReactivePlayer,-2014,10,0.300000,0.300000,0.300000,3,3,0,true,1,0,8
ReactivePlayer,-1011,10,0.300000,0.300000,0.300000,2,2,0,true,1,0,7
ReactivePlayer,-3036,10,0.300000,0.300000,0.300000,4,1,3,true,1,3,21
ReactivePlayer,-23447,10,0.300000,0.300000,0.300000,24,17,7,true,1,7,89
ReactivePlayer,-7068,10,0.300000,0.300000,0.300000,8,3,5,true,1,5,25
ReactivePlayer,-47807,10,0.300000,0.300000,0.300000,48,38,10,true,1,10,97
ReactivePlayer,-100246,10,0.300000,0.300000,0.300000,99,93,6,false,0,6,82
ReactivePlayer,-6172,10,0.300000,0.300000,0.300000,7,4,3,true,1,3,46
ReactivePlayer,-16102,10,0.300000,0.300000,0.300000,17,14,3,true,1,3,32
ReactivePlayer,-16190,10,0.300000,0.300000,0.300000,17,14,3,true,1,3,54
ReactivePlayer,-66256,10,0.300000,0.300000,0.300000,65,58,7,true,1,7,99
ReactivePlayer,-30648,10,0.300000,0.300000,0.300000,31,24,7,true,1,7,79
ReactivePlayer,-34541,10,0.300000,0.300000,0.300000,35,26,9,true,1,9,94
ReactivePlayer,-40552,10,0.300000,0.300000,0.300000,41,30,11,true,1,11,87
ReactivePlayer,920,10,0.300000,0.300000,0.300000,0,0,0,true,1,0,19
ReactivePlayer,-70600,10,0.300000,0.300000,0.300000,71,66,5,true,1,5,87
ReactivePlayer,-5056,10,0.300000,0.300000,0.300000,6,4,2,true,1,2,20
ReactivePlayer,963,10,0.300000,0.300000,0.300000,0,0,0,true,1,0,18
ReactivePlayer,-16906,10,0.300000,0.300000,0.300000,17,9,8,true,1,8,84
ReactivePlayer,-23209,10,0.300000,0.300000,0.300000,24,21,3,true,1,3,44
ReactivePlayer,-7516,10,0.300000,0.300000,0.300000,8,6,2,true,1,2,69
ReactivePlayer,-42787,10,0.300000,0.300000,0.300000,43,41,2,true,1,2,64
ReactivePlayer,997,10,0.300000,0.300000,0.300000,0,0,0,true,1,0,1
ReactivePlayer,-20399,10,0.300000,0.300000,0.300000,21,18,3,true,1,3,61
ReactivePlayer,-20,10,0.300000,0.300000,0.300000,1,0,1,true,1,1,8
ReactivePlayer,-1130,10,0.300000,0.300000,0.300000,2,0,2,true,1,2,27
ReactivePlayer,-5066,10,0.300000,0.300000,0.300000,6,5,1,true,1,1,36
ReactivePlayer,-12172,10,0.300000,0.300000,0.300000,13,7,6,true,1,6,73
ReactivePlayer,-1035,10,0.300000,0.300000,0.300000,2,0,2,true,1,2,21
ReactivePlayer,-29352,10,0.300000,0.300000,0.300000,30,27,3,true,1,3,69
ReactivePlayer,-17174,10,0.300000,0.300000,0.300000,18,14,4,true,1,4,44
ReactivePlayer,-13345,10,0.300000,0.300000,0.300000,14,9,5,true,1,5,40
ReactivePlayer,-12160,10,0.300000,0.300000,0.300000,13,8,5,true,1,5,54
ReactivePlayer,-13111,10,0.300000,0.300000,0.300000,14,7,7,true,1,7,40
ReactivePlayer,-60617,10,0.300000,0.300000,0.300000,60,53,7,true,1,7,95
ReactivePlayer,-100363,10,0.300000,0.300000,0.300000,99,92,7,false,0,7,80
ReactivePlayer,-3011,10,0.300000,0.300000,0.300000,4,1,3,true,1,3,9
ReactivePlayer,-31363,10,0.300000,0.300000,0.300000,32,25,7,true,1,7,82
ReactivePlayer,-38317,10,0.300000,0.300000,0.300000,39,34,5,true,1,5,65
ReactivePlayer,-12295,10,0.300000,0.300000,0.300000,13,7,6,true,1,6,65
ReactivePlayer,-100249,10,0.300000,0.300000,0.300000,99,92,7,false,0,7,94
ReactivePlayer,-49734,10,0.300000,0.300000,0.300000,50,47,3,true,1,3,51
ReactivePlayer,-9172,10,0.300000,0.300000,0.300000,10,8,2,true,1,2,31
ReactivePlayer,-1019,10,0.300000,0.300000,0.300000,2,1,1,true,1,1,17
ReactivePlayer,-100052,10,0.300000,0.300000,0.300000,99,97,2,false,0,2,78
ReactivePlayer,-1020,10,0.300000,0.300000,0.300000,2,0,2,true,1,2,18
ReactivePlayer,-46741,10,0.300000,0.300000,0.300000,47,42,5,true,1,5,81
ReactivePlayer,-4064,10,0.300000,0.300000,0.300000,5,1,4,true,1,4,39
ReactivePlayer,-8067,10,0.300000,0.300000,0.300000,9,8,1,true,1,1,20
ReactivePlayer,-1126,10,0.300000,0.300000,0.300000,2,0,2,true,1,2,37
ReactivePlayer,-4067,10,0.300000,0.300000,0.300000,5,2,3,true,1,3,28
ReactivePlayer,-44124,10,0.300000,0.300000,0.300000,44,38,6,true,1,6,77
ReactivePlayer,-54048,10,0.300000,0.300000,0.300000,54,46,8,true,1,8,98
ReactivePlayer,-43012,10,0.300000,0.300000,0.300000,43,35,8,true,1,8,88
ReactivePlayer,-6126,10,0.300000,0.300000,0.300000,7,4,3,true,1,3,25
ReactivePlayer,-100755,10,0.300000,0.300000,0.300000,99,91,8,false,0,8,92
ReactivePlayer,-2024,10,0.300000,0.300000,0.300000,3,1,2,true,1,2,15
ReactivePlayer,-71579,10,0.300000,0.300000,0.300000,72,65,7,true,1,7,76
ReactivePlayer,-8258,10,0.300000,0.300000,0.300000,9,4,5,true,1,5,56
ReactivePlayer,-51673,10,0.300000,0.300000,0.300000,52,47,5,true,1,5,88
ReactivePlayer,-100353,10,0.300000,0.300000,0.300000,99,90,9,false,0,9,90
ReactivePlayer,992,10,0.300000,0.300000,0.300000,0,0,0,true,1,0,5
ReactivePlayer,-27422,10,0.300000,0.300000,0.300000,28,21,7,true,1,7,74
ReactivePlayer,-4048,10,0.300000,0.300000,0.300000,5,4,1,true,1,1,21
ReactivePlayer,-223,10,0.300000,0.300000,0.300000,1,0,1,true,1,1,32
ReactivePlayer,-4101,10,0.300000,0.300000,0.300000,5,4,1,true,1,1,29
ReactivePlayer,-27363,10,0.300000,0.300000,0.300000,28,21,7,true,1,7,75
ReactivePlayer,-19151,10,0.300000,0.300000,0.300000,20,16,4,true,1,4,42
ReactivePlayer,-12171,10,0.300000,0.300000,0.300000,13,10,3,true,1,3,51
ReactivePlayer,-37371,10,0.300000,0.300000,0.300000,38,36,2,true,1,2,75
ReactivePlayer,-15142,10,0.300000,0.300000,0.300000,16,9,7,true,1,7,32
ReactivePlayer,-23687,10,0.300000,0.300000,0.300000,24,14,10,true,1,10,86
ReactivePlayer,-29180,10,0.300000,0.300000,0.300000,30,29,1,true,1,1,37
ReactivePlayer,-9249,10,0.300000,0.300000,0.300000,10,3,7,true,1,7,36
ReactivePlayer,-41323,10,0.300000,0.300000,0.300000,42,37,5,true,1,5,66
ReactivePlayer,-46826,10,0.300000,0.300000,0.300000,47,43,4,true,1,4,62
ReactivePlayer,-1025,10,0.300000,0.300000,0.300000,2,2,0,true,1,0,15
ReactivePlayer,-100713,10,0.300000,0.300000,0.300000,100,95,5,false,0,5,70
ReactivePlayer,-100045,10,0.300000,0.300000,0.300000,99,93,6,false,0,6,66
ReactivePlayer,-45580,10,0.300000,0.300000,0.300000,46,41,5,true,1,5,84
ReactivePlayer,-46923,10,0.300000,0.300000,0.300000,46,37,9,true,1,9,96
ReactivePlayer,-40327,10,0.300000,0.300000,0.300000,41,38,3,true,1,3,63
ReactivePlayer,-12101,10,0.300000,0.300000,0.300000,13,11,2,true,1,2,40
ReactivePlayer,990,10,0.300000,0.300000,0.300000,0,0,0,true,1,0,5
ReactivePlayer,-58844,10,0.300000,0.300000,0.300000,59,55,4,true,1,4,83
ReactivePlayer,-1039,10,0.300000,0.300000,0.300000,2,0,2,true,1,2,23
ReactivePlayer,-52878,10,0.300000,0.300000,0.300000,53,47,6,true,1,6,93
ReactivePlayer,-4114,10,0.300000,0.300000,0.300000,5,4,1,true,1,1,18
ReactivePlayer,-13302,10,0.300000,0.300000,0.300000,14,12,2,true,1,2,33
ReactivePlayer,-100705,10,0.300000,0.300000,0.300000,100,95,5,false,0,5,79
ReactivePlayer,-17127,10,0.300000,0.300000,0.300000,18,13,5,true,1,5,49
ReactivePlayer,-16,10,0.300000,0.300000,0.300000,1,0,1,true,1,1,12
ReactivePlayer,-35394,10,0.300000,0.300000,0.300000,35,28,7,true,1,7,98
ReactivePlayer,976,10,0.300000,0.300000,0.300000,0,0,0,true,1,0,11
ReactivePlayer,-100267,10,0.300000,0.300000,0.300000,99,90,9,false,0,9,84
ReactivePlayer,-100350,10,0.300000,0.300000,0.300000,99,92,7,false,0,7,90
ReactivePlayer,-7099,10,0.300000,0.300000,0.300000,8,3,5,true,1,5,48
ReactivePlayer,-100620,10,0.300000,0.300000,0.300000,100,97,3,false,0,3,60
ReactivePlayer,-4111,10,0.300000,0.300000,0.300000,5,4,1,true,1,1,33
ReactivePlayer,-100155,10,0.300000,0.300000,0.300000,99,92,7,false,0,7,77
ReactivePlayer,-17170,10,0.300000,0.300000,0.300000,18,16,2,true,1,2,23
ReactivePlayer,-6106,10,0.300000,0.300000,0.300000,7,4,3,true,1,3,25
ReactivePlayer,-30468,10,0.300000,0.300000,0.300000,31,29,2,true,1,2,54
ReactivePlayer,-15233,10,0.300000,0.300000,0.300000,16,13,3,true,1,3,39
ReactivePlayer,-38499,10,0.300000,0.300000,0.300000,39,35,4,true,1,4,71
ReactivePlayer,-11310,10,0.300000,0.300000,0.300000,12,3,9,true,1,9,63
ReactivePlayer,-100026,10,0.300000,0.300000,0.300000,99,95,4,false,0,4,98
ReactivePlayer,-4047,10,0.300000,0.300000,0.300000,5,2,3,true,1,3,19
ReactivePlayer,-12197,10,0.300000,0.300000,0.300000,13,12,1,true,1,1,60
ReactivePlayer,-3076,10,0.300000,0.300000,0.300000,4,4,0,true,1,0,31
ReactivePlayer,-4088,10,0.300000,0.300000,0.300000,5,4,1,true,1,1,42
ReactivePlayer,-4090,10,0.300000,0.300000,0.300000,5,0,5,true,1,5,28
ReactivePlayer,-21484,10,0.300000,0.300000,0.300000,22,16,6,true,1,6,54
ReactivePlayer,-47021,10,0.300000,0.300000,0.300000,47,42,5,true,1,5,94
ReactivePlayer,-91875,10,0.300000,0.300000,0.300000,92,87,5,true,1,5,94
ReactivePlayer,-11129,10,0.300000,0.300000,0.300000,12,10,2,true,1,2,39
ReactivePlayer,-29297,10,0.300000,0.300000,0.300000,30,26,4,true,1,4,53
ReactivePlayer,-3030,10,0.300000,0.300000,0.300000,4,2,2,true,1,2,17
ReactivePlayer,-8523,10,0.300000,0.300000,0.300000,9,1,8,true,1,8,59
ReactivePlayer,-24388,10,0.300000,0.300000,0.300000,25,19,6,true,1,6,78
ReactivePlayer,-7,10,0.300000,0.300000,0.300000,1,0,1,true,1,1,4
ReactivePlayer,-40523,10,0.300000,0.300000,0.300000,41,39,2,true,1,2,61
ReactivePlayer,-3028,10,0.300000,0.300000,0.300000,4,3,1,true,1,1,16
ReactivePlayer,-5373,10,0.300000,0.300000,0.300000,6,2,4,true,1,4,44
ReactivePlayer,-29544,10,0.300000,0.300000,0.300000,30,27,3,true,1,3,68
ReactivePlayer,-7075,10,0.300000,0.300000,0.300000,8,2,6,true,1,6,37
ReactivePlayer,-16254,10,0.300000,0.300000,0.300000,17,16,1,true,1,1,57
ReactivePlayer,-29174,10,0.300000,0.300000,0.300000,30,28,2,true,1,2,36
ReactivePlayer,-49593,10,0.300000,0.300000,0.300000,50,45,5,true,1,5,80
ReactivePlayer,-16386,10,0.300000,0.300000,0.300000,17,14,3,true,1,3,56
ReactivePlayer,-7050,10,0.300000,0.300000,0.300000,8,5,3,true,1,3,26
ReactivePlayer,-37180,10,0.300000,0.300000,0.300000,37,26,11,true,1,11,92
ReactivePlayer,-67114,10,0.300000,0.300000,0.300000,67,62,5,true,1,5,88
ReactivePlayer,-7046,10,0.300000,0.300000,0.300000,8,5,3,true,1,3,12
ReactivePlayer,-80111,10,0.300000,0.300000,0.300000,80,77,3,true,1,3,77
ReactivePlayer,-76151,10,0.300000,0.300000,0.300000,76,64,12,true,1,12,98
ReactivePlayer,-56216,10,0.300000,0.300000,0.300000,56,52,4,true,1,4,83
ReactivePlayer,-22395,10,0.300000,0.300000,0.300000,23,21,2,true,1,2,30
ReactivePlayer,-31289,10,0.300000,0.300000,0.300000,32,26,6,true,1,6,61
ReactivePlayer,-26289,10,0.300000,0.300000,0.300000,27,23,4,true,1,4,58
ReactivePlayer,-20190,10,0.300000,0.300000,0.300000,21,16,5,true,1,5,53
ReactivePlayer,-21581,10,0.300000,0.300000,0.300000,22,17,5,true,1,5,73
ReactivePlayer,-24355,10,0.300000,0.300000,0.300000,25,21,4,true,1,4,56
ReactivePlayer,-18141,10,0.300000,0.300000,0.300000,19,15,4,true,1,4,34
ReactivePlayer,-53,10,0.300000,0.300000,0.300000,1,0,1,true,1,1,8
ReactivePlayer,-23498,10,0.300000,0.300000,0.300000,24,18,6,true,1,6,68
ReactivePlayer,-10219,10,0.300000,0.300000,0.300000,11,8,3,true,1,3,51
ReactivePlayer,-16,10,0.300000,0.300000,0.300000,1,0,1,true,1,1,11
ReactivePlayer,-12170,10,0.300000,0.300000,0.300000,13,9,4,true,1,4,39
ReactivePlayer,-49562,10,0.300000,0.300000,0.300000,50,48,2,true,1,2,62
ReactivePlayer,-18,10,0.300000,0.300000,0.300000,1,1,0,true,1,0,11
ReactivePlayer,-38572,10,0.300000,0.300000,0.300000,39,35,4,true,1,4,60
ReactivePlayer,-94770,10,0.300000,0.300000,0.300000,95,90,5,true,1,5,69
ReactivePlayer,-8447,10,0.300000,0.300000,0.300000,9,4,5,true,1,5,65
ReactivePlayer,-91182,10,0.300000,0.300000,0.300000,91,82,9,true,1,9,94
ReactivePlayer,-100767,10,0.300000,0.300000,0.300000,100,91,9,false,0,9,79
ReactivePlayer,-20441,10,0.300000,0.300000,0.300000,21,13,8,true,1,8,75
ReactivePlayer,-9168,10,0.300000,0.300000,0.300000,10,7,3,true,1,3,43
ReactivePlayer,-100648,10,0.300000,0.300000,0.300000,99,93,6,false,0,6,100
ReactivePlayer,-21510,10,0.300000,0.300000,0.300000,22,17,5,true,1,5,76
ReactivePlayer,-47798,10,0.300000,0.300000,0.300000,48,44,4,true,1,4,94
ReactivePlayer,-15189,10,0.300000,0.300000,0.300000,16,12,4,true,1,4,53
ReactivePlayer,-19229,10,0.300000,0.300000,0.300000,20,16,4,true,1,4,72
ReactivePlayer,-10617,10,0.300000,0.300000,0.300000,11,8,3,true,1,3,96
ReactivePlayer,-34249,10,0.300000,0.300000,0.300000,35,34,1,true,1,1,37
ReactivePlayer,-19235,10,0.300000,0.300000,0.300000,20,19,1,true,1,1,64
ReactivePlayer,-1008,10,0.300000,0.300000,0.300000,2,1,1,true,1,1,8
ReactivePlayer,-29899,10,0.300000,0.300000,0.300000,30,26,4,true,1,4,70
ReactivePlayer,-18655,10,0.300000,0.300000,0.300000,19,10,9,true,1,9,85
ReactivePlayer,-100121,10,0.300000,0.300000,0.300000,99,92,7,false,0,7,80
ReactivePlayer,-8079,10,0.300000,0.300000,0.300000,9,9,0,true,1,0,18
ReactivePlayer,-4212,10,0.300000,0.300000,0.300000,5,2,3,true,1,3,35
ReactivePlayer,-28706,10,0.300000,0.300000,0.300000,29,23,6,true,1,6,85
ReactivePlayer,-5040,10,0.300000,0.300000,0.300000,6,1,5,true,1,5,15
ReactivePlayer,-77872,10,0.300000,0.300000,0.300000,76,66,10,true,1,10,96
ReactivePlayer,-9112,10,0.300000,0.300000,0.300000,10,9,1,true,1,1,31
ReactivePlayer,-17421,10,0.300000,0.300000,0.300000,18,15,3,true,1,3,72
ReactivePlayer,-100029,10,0.300000,0.300000,0.300000,99,94,5,false,0,5,69
ReactivePlayer,993,10,0.300000,0.300000,0.300000,0,0,0,true,1,0,6
ReactivePlayer,-40919,10,0.300000,0.300000,0.300000,41,35,6,true,1,6,80
ReactivePlayer,-28243,10,0.300000,0.300000,0.300000,29,28,1,true,1,1,58
ReactivePlayer,-3050,10,0.300000,0.300000,0.300000,4,2,2,true,1,2,28
ReactivePlayer,-18248,10,0.300000,0.300000,0.300000,19,17,2,true,1,2,49
ReactivePlayer,990,10,0.300000,0.300000,0.300000,0,0,0,true,1,0,5
ReactivePlayer,-26510,10,0.300000,0.300000,0.300000,27,24,3,true,1,3,44
ReactivePlayer,-3043,10,0.300000,0.300000,0.300000,4,2,2,true,1,2,20
ReactivePlayer,-32237,10,0.300000,0.300000,0.300000,33,24,9,true,1,9,60
ReactivePlayer,-35591,10,0.300000,0.300000,0.300000,36,27,9,true,1,9,87
ReactivePlayer,-34295,10,0.300000,0.300000,0.300000,34,31,3,true,1,3,94
ReactivePlayer,-5322,10,0.300000,0.300000,0.300000,6,1,5,true,1,5,56
ReactivePlayer,-12095,10,0.300000,0.300000,0.300000,13,11,2,true,1,2,45
ReactivePlayer,-100064,10,0.300000,0.300000,0.300000,98,89,9,false,0,9,92
ReactivePlayer,-33744,10,0.300000,0.300000,0.300000,34,28,6,true,1,6,98
ReactivePlayer,-9072,10,0.300000,0.300000,0.300000,10,9,1,true,1,1,17
ReactivePlayer,-100372,10,0.300000,0.300000,0.300000,99,91,8,false,0,8,100
ReactivePlayer,961,10,0.300000,0.300000,0.300000,0,0,0,true,1,0,17
ReactivePlayer,-6037,10,0.300000,0.300000,0.300000,7,6,1,true,1,1,19
ReactivePlayer,-32785,10,0.300000,0.300000,0.300000,33,25,8,true,1,8,81
ReactivePlayer,-100445,10,0.300000,0.300000,0.300000,99,95,4,false,0,4,90
ReactivePlayer,-5074,10,0.300000,0.300000,0.300000,6,6,0,true,1,0,30
ReactivePlayer,-19637,10,0.300000,0.300000,0.300000,20,13,7,true,1,7,68
ReactivePlayer,-16334,10,0.300000,0.300000,0.300000,17,16,1,true,1,1,49
ReactivePlayer,-28333,10,0.300000,0.300000,0.300000,29,24,5,true,1,5,70
ReactivePlayer,-20181,10,0.300000,0.300000,0.300000,21,17,4,true,1,4,44
ReactivePlayer,-16327,10,0.300000,0.300000,0.300000,17,10,7,true,1,7,70
ReactivePlayer,-6219,10,0.300000,0.300000,0.300000,7,4,3,true,1,3,49
ReactivePlayer,-38943,10,0.300000,0.300000,0.300000,39,35,4,true,1,4,98
ReactivePlayer,-15297,10,0.300000,0.300000,0.300000,16,13,3,true,1,3,41
ReactivePlayer,-69885,10,0.300000,0.300000,0.300000,69,66,3,true,1,3,94
ReactivePlayer,-236,10,0.300000,0.300000,0.300000,1,0,1,true,1,1,36
ReactivePlayer,-67584,10,0.300000,0.300000,0.300000,68,64,4,true,1,4,60
ReactivePlayer,-22464,10,0.300000,0.300000,0.300000,23,22,1,true,1,1,86
ReactivePlayer,-82684,10,0.300000,0.300000,0.300000,82,77,5,true,1,5,97
ReactivePlayer,-11,10,0.300000,0.300000,0.300000,1,0,1,true,1,1,11
ReactivePlayer,-12,10,0.300000,0.300000,0.300000,1,1,0,true,1,0,9
ReactivePlayer,-35400,10,0.300000,0.300000,0.300000,36,29,7,true,1,7,62
ReactivePlayer,-5063,10,0.300000,0.300000,0.300000,6,4,2,true,1,2,16
ReactivePlayer,-3082,10,0.300000,0.300000,0.300000,4,3,1,true,1,1,35
ReactivePlayer,-96137,10,0.300000,0.300000,0.300000,96,93,3,true,1,3,66
ReactivePlayer,-92026,10,0.300000,0.300000,0.300000,92,86,6,true,1,6,90
ReactivePlayer,-14240,10,0.300000,0.300000,0.300000,15,11,4,true,1,4,43
ReactivePlayer,-76613,10,0.300000,0.300000,0.300000,77,72,5,true,1,5,64
ReactivePlayer,-9167,10,0.300000,0.300000,0.300000,10,7,3,true,1,3,51
ReactivePlayer,-15235,10,0.300000,0.300000,0.300000,16,11,5,true,1,5,66
ReactivePlayer,-5065,10,0.300000,0.300000,0.300000,6,4,2,true,1,2,26
ReactivePlayer,-13302,10,0.300000,0.300000,0.300000,14,7,7,true,1,7,46
ReactivePlayer,-2184,10,0.300000,0.300000,0.300000,3,1,2,true,1,2,32
ReactivePlayer,-100704,10,0.300000,0.300000,0.300000,100,97,3,false,0,3,68
ReactivePlayer,-22553,10,0.300000,0.300000,0.300000,23,18,5,true,1,5,74
ReactivePlayer,-27186,10,0.300000,0.300000,0.300000,28,26,2,true,1,2,46
ReactivePlayer,-6053,10,0.300000,0.300000,0.300000,7,7,0,true,1,0,13
ReactivePlayer,-13692,10,0.300000,0.300000,0.300000,14,12,2,true,1,2,70
ReactivePlayer,-2083,10,0.300000,0.300000,0.300000,3,2,1,true,1,1,23
ReactivePlayer,-87213,10,0.300000,0.300000,0.300000,87,80,7,true,1,7,95
ReactivePlayer,-28507,10,0.300000,0.300000,0.300000,29,22,7,true,1,7,91
ReactivePlayer,-65214,10,0.300000,0.300000,0.300000,65,55,10,true,1,10,89
ReactivePlayer,-90865,10,0.300000,0.300000,0.300000,91,85,6,true,1,6,83
ReactivePlayer,-35324,10,0.300000,0.300000,0.300000,36,26,10,true,1,10,78
ReactivePlayer,-69475,10,0.300000,0.300000,0.300000,70,63,7,true,1,7,70
ReactivePlayer,-82036,10,0.300000,0.300000,0.300000,82,72,10,true,1,10,96
ReactivePlayer,-59269,10,0.300000,0.300000,0.300000,59,48,11,true,1,11,96
ReactivePlayer,-49388,10,0.300000,0.300000,0.300000,50,45,5,true,1,5,73
ReactivePlayer,-30287,10,0.300000,0.300000,0.300000,31,24,7,true,1,7,66
ReactivePlayer,-10181,10,0.300000,0.300000,0.300000,11,8,3,true,1,3,50
ReactivePlayer,-55,10,0.300000,0.300000,0.300000,1,0,1,true,1,1,36
ReactivePlayer,-48422,10,0.300000,0.300000,0.300000,49,41,8,true,1,8,68
ReactivePlayer,-72934,10,0.300000,0.300000,0.300000,73,69,4,true,1,4,92
ReactivePlayer,-4220,10,0.300000,0.300000,0.300000,5,3,2,true,1,2,39
ReactivePlayer,-11157,10,0.300000,0.300000,0.300000,12,11,1,true,1,1,32
ReactivePlayer,-72204,10,0.300000,0.300000,0.300000,71,62,9,true,1,9,100
ReactivePlayer,-2073,10,0.300000,0.300000,0.300000,3,0,3,true,1,3,22
ReactivePlayer,-1097,10,0.300000,0.300000,0.300000,2,0,2,true,1,2,32
ReactivePlayer,-1050,10,0.300000,0.300000,0.300000,2,1,1,true,1,1,17
ReactivePlayer,-100521,10,0.300000,0.300000,0.300000,99,90,9,false,0,9,98
ReactivePlayer,991,10,0.300000,0.300000,0.300000,0,0,0,true,1,0,7
ReactivePlayer,-15318,10,0.300000,0.300000,0.300000,16,11,5,true,1,5,57
ReactivePlayer,-30851,10,0.300000,0.300000,0.300000,30,19,11,true,1,11,100
ReactivePlayer,-57885,10,0.300000,0.300000,0.300000,58,54,4,true,1,4,82
ReactivePlayer,976,10,0.300000,0.300000,0.300000,0,0,0,true,1,0,8
ReactivePlayer,-53207,10,0.300000,0.300000,0.300000,53,44,9,true,1,9,93
ReactivePlayer,-36549,10,0.300000,0.300000,0.300000,37,31,6,true,1,6,81
ReactivePlayer,-5078,10,0.300000,0.300000,0.300000,6,5,1,true,1,1,18
ReactivePlayer,-21273,10,0.300000,0.300000,0.300000,22,14,8,true,1,8,63
ReactivePlayer,-61630,10,0.300000,0.300000,0.300000,62,56,6,true,1,6,88
ReactivePlayer,-12155,10,0.300000,0.300000,0.300000,13,11,2,true,1,2,43
ReactivePlayer,-4097,10,0.300000,0.300000,0.300000,5,5,0,true,1,0,27
ReactivePlayer,-39686,10,0.300000,0.300000,0.300000,40,28,12,true,1,12,79
ReactivePlayer,-3076,10,0.300000,0.300000,0.300000,4,3,1,true,1,1,27
ReactivePlayer,-11069,10,0.300000,0.300000,0.300000,12,10,2,true,1,2,17
ReactivePlayer,-19494,10,0.300000,0.300000,0.300000,20,12,8,true,1,8,80
ReactivePlayer,-6351,10,0.300000,0.300000,0.300000,7,4,3,true,1,3,58
ReactivePlayer,-3120,10,0.300000,0.300000,0.300000,4,1,3,true,1,3,35
ReactivePlayer,-8198,10,0.300000,0.300000,0.300000,9,6,3,true,1,3,48
ReactivePlayer,-20283,10,0.300000,0.300000,0.300000,21,15,6,true,1,6,63
ReactivePlayer,-37283,10,0.300000,0.300000,0.300000,38,32,6,true,1,6,69
ReactivePlayer,-51732,10,0.300000,0.300000,0.300000,52,45,7,true,1,7,97
ReactivePlayer,-40750,10,0.300000,0.300000,0.300000,41,37,4,true,1,4,92
ReactivePlayer,-80196,10,0.300000,0.300000,0.300000,80,74,6,true,1,6,100
ReactivePlayer,-40584,10,0.300000,0.300000,0.300000,41,32,9,true,1,9,80
ReactivePlayer,-59540,10,0.300000,0.300000,0.300000,60,49,11,true,1,11,83
ReactivePlayer,-12234,10,0.300000,0.300000,0.300000,13,9,4,true,1,4,48
ReactivePlayer,-2124,10,0.300000,0.300000,0.300000,3,3,0,true,1,0,36
ReactivePlayer,-84992,10,0.300000,0.300000,0.300000,85,81,4,true,1,4,86
ReactivePlayer,-64209,10,0.300000,0.300000,0.300000,64,56,8,true,1,8,96
ReactivePlayer,-47,10,0.300000,0.300000,0.300000,1,0,1,true,1,1,27
ReactivePlayer,-4027,10,0.300000,0.300000,0.300000,5,5,0,true,1,0,4
ReactivePlayer,-11345,10,0.300000,0.300000,0.300000,12,9,3,true,1,3,55
ReactivePlayer,-15202,10,0.300000,0.300000,0.300000,16,14,2,true,1,2,40
ReactivePlayer,-22310,10,0.300000,0.300000,0.300000,23,17,6,true,1,6,71
ReactivePlayer,999,10,0.300000,0.300000,0.300000,0,0,0,true,1,0,1
ReactivePlayer,-36,10,0.300000,0.300000,0.300000,1,0,1,true,1,1,13
ReactivePlayer,-40675,10,0.300000,0.300000,0.300000,41,36,5,true,1,5,80
ReactivePlayer,-58474,10,0.300000,0.300000,0.300000,58,54,4,true,1,4,86
ReactivePlayer,-12230,10,0.300000,0.300000,0.300000,13,11,2,true,1,2,51
ReactivePlayer,-11103,10,0.300000,0.300000,0.300000,12,10,2,true,1,2,24
ReactivePlayer,-27321,10,0.300000,0.300000,0.300000,28,25,3,true,1,3,33
ReactivePlayer,-26188,10,0.300000,0.300000,0.300000,27,24,3,true,1,3,59
ReactivePlayer,-69635,10,0.300000,0.300000,0.300000,70,66,4,true,1,4,71
ReactivePlayer,-15208,10,0.300000,0.300000,0.300000,16,12,4,true,1,4,49
ReactivePlayer,-29444,10,0.300000,0.300000,0.300000,30,24,6,true,1,6,71
ReactivePlayer,-16115,10,0.300000,0.300000,0.300000,17,11,6,true,1,6,48
ReactivePlayer,-30699,10,0.300000,0.300000,0.300000,31,23,8,true,1,8,94
ReactivePlayer,-14,10,0.300000,0.300000,0.300000,1,0,1,true,1,1,9
ReactivePlayer,-1017,10,0.300000,0.300000,0.300000,2,1,1,true,1,1,16
ReactivePlayer,991,10,0.300000,0.300000,0.300000,0,0,0,true,1,0,7
ReactivePlayer,-100313,10,0.300000,0.300000,0.300000,99,97,2,false,0,2,90
ReactivePlayer,-17185,10,0.300000,0.300000,0.300000,18,15,3,true,1,3,50
ReactivePlayer,-13230,10,0.300000,0.300000,0.300000,14,12,2,true,1,2,51
ReactivePlayer,-8169,10,0.300000,0.300000,0.300000,9,6,3,true,1,3,38
ReactivePlayer,-40408,10,0.300000,0.300000,0.300000,41,34,7,true,1,7,84
ReactivePlayer,-52,10,0.300000,0.300000,0.300000,1,0,1,true,1,1,19
ReactivePlayer,997,10,0.300000,0.300000,0.300000,0,0,0,true,1,0,3
ReactivePlayer,-32561,10,0.300000,0.300000,0.300000,33,26,7,true,1,7,71
ReactivePlayer,-13791,10,0.300000,0.300000,0.300000,14,11,3,true,1,3,91
ReactivePlayer,-28421,10,0.300000,0.300000,0.300000,29,24,5,true,1,5,69
ReactivePlayer,-100265,10,0.300000,0.300000,0.300000,99,96,3,false,0,3,93
ReactivePlayer,976,10,0.300000,0.300000,0.300000,0,0,0,true,1,0,12
ReactivePlayer,1000,10,0.300000,0.300000,0.300000,0,0,0,true,1,0,0
ReactivePlayer,-26749,10,0.300000,0.300000,0.300000,27,21,6,true,1,6,93
ReactivePlayer,-32220,10,0.300000,0.300000,0.300000,33,31,2,true,1,2,46
ReactivePlayer,-34333,10,0.300000,0.300000,0.300000,35,24,11,true,1,11,63
ReactivePlayer,-96761,10,0.300000,0.300000,0.300000,96,85,11,true,1,11,98
ReactivePlayer,-18160,10,0.300000,0.300000,0.300000,19,12,7,true,1,7,55
ReactivePlayer,-9269,10,0.300000,0.300000,0.300000,10,7,3,true,1,3,75
ReactivePlayer,-27496,10,0.300000,0.300000,0.300000,28,25,3,true,1,3,63
ReactivePlayer,-100905,10,0.300000,0.300000,0.300000,100,97,3,false,0,3,89
ReactivePlayer,-1030,10,0.300000,0.300000,0.300000,2,1,1,true,1,1,20
ReactivePlayer,-5129,10,0.300000,0.300000,0.300000,6,2,4,true,1,4,44
ReactivePlayer,-13191,10,0.300000,0.300000,0.300000,14,6,8,true,1,8,39
ReactivePlayer,-7253,10,0.300000,0.300000,0.300000,8,4,4,true,1,4,37
ReactivePlayer,-35837,10,0.300000,0.300000,0.300000,36,30,6,true,1,6,81
ReactivePlayer,-11197,10,0.300000,0.300000,0.300000,12,8,4,true,1,4,50
ReactivePlayer,-7143,10,0.300000,0.300000,0.300000,8,2,6,true,1,6,32
ReactivePlayer,-55033,10,0.300000,0.300000,0.300000,55,52,3,true,1,3,76
ReactivePlayer,-5130,10,0.300000,0.300000,0.300000,6,3,3,true,1,3,53
ReactivePlayer,-50286,10,0.300000,0.300000,0.300000,51,50,1,true,1,1,41
ReactivePlayer,-3040,10,0.300000,0.300000,0.300000,4,0,4,true,1,4,20
ReactivePlayer,-14155,10,0.300000,0.300000,0.300000,15,8,7,true,1,7,50
ReactivePlayer,-34187,10,0.300000,0.300000,0.300000,35,33,2,true,1,2,48
ReactivePlayer,-100292,10,0.300000,0.300000,0.300000,98,89,9,false,0,9,97
ReactivePlayer,-2034,10,0.300000,0.300000,0.300000,3,3,0,true,1,0,10
ReactivePlayer,-21459,10,0.300000,0.300000,0.300000,22,17,5,true,1,5,82
ReactivePlayer,-15398,10,0.300000,0.300000,0.300000,16,9,7,true,1,7,78
ReactivePlayer,-21264,10,0.300000,0.300000,0.300000,22,17,5,true,1,5,36
ReactivePlayer,-1008,10,0.300000,0.300000,0.300000,2,0,2,true,1,2,6
ReactivePlayer,-12190,10,0.300000,0.300000,0.300000,13,7,6,true,1,6,43
ReactivePlayer,-1050,10,0.300000,0.300000,0.300000,2,0,2,true,1,2,24
ReactivePlayer,-100421,10,0.300000,0.300000,0.300000,99,85,14,false,0,14,97
ReactivePlayer,981,10,0.300000,0.300000,0.300000,0,0,0,true,1,0,13
ReactivePlayer,-34364,10,0.300000,0.300000,0.300000,35,27,8,true,1,8,69
ReactivePlayer,-63613,10,0.300000,0.300000,0.300000,64,57,7,true,1,7,82
ReactivePlayer,985,10,0.300000,0.300000,0.300000,0,0,0,true,1,0,10
ReactivePlayer,-3110,10,0.300000,0.300000,0.300000,4,1,3,true,1,3,26
ReactivePlayer,-87375,10,0.300000,0.300000,0.300000,87,78,9,true,1,9,82
ReactivePlayer,-85031,10,0.300000,0.300000,0.300000,85,78,7,true,1,7,76
ReactivePlayer,-10338,10,0.300000,0.300000,0.300000,11,6,5,true,1,5,73
ReactivePlayer,-8111,10,0.300000,0.300000,0.300000,9,7,2,true,1,2,25
ReactivePlayer,-52757,10,0.300000,0.300000,0.300000,53,46,7,true,1,7,84
ReactivePlayer,-18277,10,0.300000,0.300000,0.300000,19,12,7,true,1,7,65
ReactivePlayer,998,10,0.300000,0.300000,0.300000,0,0,0,true,1,0,2
ReactivePlayer,-100300,10,0.300000,0.300000,0.300000,98,93,5,false,0,5,98
ReactivePlayer,-100198,10,0.300000,0.300000,0.300000,98,93,5,false,0,5,78
ReactivePlayer,-16419,10,0.300000,0.300000,0.300000,17,12,5,true,1,5,86
ReactivePlayer,-21270,10,0.300000,0.300000,0.300000,22,19,3,true,1,3,66
ReactivePlayer,-33761,10,0.300000,0.300000,0.300000,34,29,5,true,1,5,73
ReactivePlayer,-25300,10,0.300000,0.300000,0.300000,26,24,2,true,1,2,51
ReactivePlayer,-37513,10,0.300000,0.300000,0.300000,38,34,4,true,1,4,63
ReactivePlayer,-37444,10,0.300000,0.300000,0.300000,38,33,5,true,1,5,86
ReactivePlayer,-100021,10,0.300000,0.300000,0.300000,99,94,5,false,0,5,83
ReactivePlayer,-100568,10,0.300000,0.300000,0.300000,100,91,9,false,0,9,81
ReactivePlayer,-59810,10,0.300000,0.300000,0.300000,60,58,2,true,1,2,91
ReactivePlayer,-100840,10,0.300000,0.300000,0.300000,98,92,6,false,0,6,93
ReactivePlayer,-39725,10,0.300000,0.300000,0.300000,40,39,1,true,1,1,55
ReactivePlayer,-39444,10,0.300000,0.300000,0.300000,40,32,8,true,1,8,77
ReactivePlayer,-62631,10,0.300000,0.300000,0.300000,63,55,8,true,1,8,87
ReactivePlayer,-14275,10,0.300000,0.300000,0.300000,15,10,5,true,1,5,64
ReactivePlayer,-13297,10,0.300000,0.300000,0.300000,14,7,7,true,1,7,64
ReactivePlayer,-46695,10,0.300000,0.300000,0.300000,47,43,4,true,1,4,85
ReactivePlayer,-43511,10,0.300000,0.300000,0.300000,44,37,7,true,1,7,76
ReactivePlayer,992,10,0.300000,0.300000,0.300000,0,0,0,true,1,0,6
ReactivePlayer,-25402,10,0.300000,0.300000,0.300000,26,22,4,true,1,4,82
ReactivePlayer,-42014,10,0.300000,0.300000,0.300000,42,35,7,true,1,7,86
ReactivePlayer,958,10,0.300000,0.300000,0.300000,0,0,0,true,1,0,10
ReactivePlayer,-14076,10,0.300000,0.300000,0.300000,15,11,4,true,1,4,30
ReactivePlayer,-3029,10,0.300000,0.300000,0.300000,4,1,3,true,1,3,18
ReactivePlayer,-16345,10,0.300000,0.300000,0.300000,17,15,2,true,1,2,67
ReactivePlayer,-22214,10,0.300000,0.300000,0.300000,23,20,3,true,1,3,50
ReactivePlayer,-27278,10,0.300000,0.300000,0.300000,28,26,2,true,1,2,58
ReactivePlayer,-21397,10,0.300000,0.300000,0.300000,22,16,6,true,1,6,70
ReactivePlayer,-65882,10,0.300000,0.300000,0.300000,66,59,7,true,1,7,89
ReactivePlayer,-1029,10,0.300000,0.300000,0.300000,2,1,1,true,1,1,16
ReactivePlayer,-61781,10,0.300000,0.300000,0.300000,62,51,11,true,1,11,87
ReactivePlayer,-18939,10,0.300000,0.300000,0.300000,19,12,7,true,1,7,98
ReactivePlayer,-20356,10,0.300000,0.300000,0.300000,21,14,7,true,1,7,63
ReactivePlayer,-44736,10,0.300000,0.300000,0.300000,45,35,10,true,1,10,96
ReactivePlayer,-1041,10,0.300000,0.300000,0.300000,2,0,2,true,1,2,17
ReactivePlayer,1000,10,0.300000,0.300000,0.300000,0,0,0,true,1,0,0
ReactivePlayer,-5080,10,0.300000,0.300000,0.300000,6,5,1,true,1,1,24
ReactivePlayer,-54501,10,0.300000,0.300000,0.300000,55,47,8,true,1,8,70
ReactivePlayer,-8116,10,0.300000,0.300000,0.300000,9,3,6,true,1,6,51
ReactivePlayer,-31437,10,0.300000,0.300000,0.300000,32,27,5,true,1,5,54
ReactivePlayer,-75153,10,0.300000,0.300000,0.300000,75,69,6,true,1,6,95
ReactivePlayer,-61373,10,0.300000,0.300000,0.300000,61,53,8,true,1,8,100
ReactivePlayer,-6149,10,0.300000,0.300000,0.300000,7,5,2,true,1,2,44
ReactivePlayer,-100837,10,0.300000,0.300000,0.300000,100,93,7,false,0,7,86
ReactivePlayer,999,10,0.300000,0.300000,0.300000,0,0,0,true,1,0,1
ReactivePlayer,-86721,10,0.300000,0.300000,0.300000,87,80,7,true,1,7,73
ReactivePlayer,941,10,0.300000,0.300000,0.300000,0,0,0,true,1,0,11
ReactivePlayer,-28454,10,0.300000,0.300000,0.300000,29,17,12,true,1,12,97
ReactivePlayer,-5034,10,0.300000,0.300000,0.300000,6,4,2,true,1,2,16
ReactivePlayer,-27178,10,0.300000,0.300000,0.300000,28,21,7,true,1,7,32
ReactivePlayer,-44669,10,0.300000,0.300000,0.300000,45,37,8,true,1,8,90
ReactivePlayer,-9213,10,0.300000,0.300000,0.300000,10,7,3,true,1,3,40
ReactivePlayer,-34565,10,0.300000,0.300000,0.300000,35,24,11,true,1,11,82
ReactivePlayer,-36389,10,0.300000,0.300000,0.300000,37,29,8,true,1,8,77
ReactivePlayer,-3043,10,0.300000,0.300000,0.300000,4,4,0,true,1,0,15
ReactivePlayer,-100192,10,0.300000,0.300000,0.300000,99,98,1,false,0,1,85
ReactivePlayer,1000,10,0.300000,0.300000,0.300000,0,0,0,true,1,0,0
ReactivePlayer,-9156,10,0.300000,0.300000,0.300000,10,5,5,true,1,5,50
ReactivePlayer,-29571,10,0.300000,0.300000,0.300000,30,28,2,true,1,2,35
ReactivePlayer,-4096,10,0.300000,0.300000,0.300000,5,2,3,true,1,3,33
ReactivePlayer,1000,10,0.300000,0.300000,0.300000,0,0,0,true,1,0,0
ReactivePlayer,-18311,10,0.300000,0.300000,0.300000,19,14,5,true,1,5,59
ReactivePlayer,-41343,10,0.300000,0.300000,0.300000,42,38,4,true,1,4,62
ReactivePlayer,-23249,10,0.300000,0.300000,0.300000,24,22,2,true,1,2,46
ReactivePlayer,-23653,10,0.300000,0.300000,0.300000,24,19,5,true,1,5,73
ReactivePlayer,-53624,10,0.300000,0.300000,0.300000,54,47,7,true,1,7,82
ReactivePlayer,998,10,0.300000,0.300000,0.300000,0,0,0,true,1,0,2
ReactivePlayer,-6170,10,0.300000,0.300000,0.300000,7,5,2,true,1,2,51
ReactivePlayer,-14143,10,0.300000,0.300000,0.300000,15,11,4,true,1,4,38
ReactivePlayer,-81757,10,0.300000,0.300000,0.300000,82,80,2,true,1,2,53
ReactivePlayer,-14190,10,0.300000,0.300000,0.300000,15,11,4,true,1,4,51
ReactivePlayer,-100891,10,0.300000,0.300000,0.300000,99,90,9,false,0,9,92
ReactivePlayer,-6211,10,0.300000,0.300000,0.300000,7,6,1,true,1,1,40
ReactivePlayer,-27261,10,0.300000,0.300000,0.300000,28,27,1,true,1,1,36
ReactivePlayer,-17143,10,0.300000,0.300000,0.300000,18,18,0,true,1,0,28
ReactivePlayer,-18445,10,0.300000,0.300000,0.300000,19,14,5,true,1,5,59
ReactivePlayer,965,10,0.300000,0.300000,0.300000,0,0,0,true,1,0,10
ReactivePlayer,-83881,10,0.300000,0.300000,0.300000,84,82,2,true,1,2,49
ReactivePlayer,-34541,10,0.300000,0.300000,0.300000,35,30,5,true,1,5,63
ReactivePlayer,-13,10,0.300000,0.300000,0.300000,1,1,0,true,1,0,11
ReactivePlayer,-28442,10,0.300000,0.300000,0.300000,29,26,3,true,1,3,59
ReactivePlayer,-100937,10,0.300000,0.300000,0.300000,100,95,5,false,0,5,82
ReactivePlayer,-2091,10,0.300000,0.300000,0.300000,3,3,0,true,1,0,21
ReactivePlayer,-4074,10,0.300000,0.300000,0.300000,5,3,2,true,1,2,33
ReactivePlayer,-9245,10,0.300000,0.300000,0.300000,10,7,3,true,1,3,48
ReactivePlayer,-12214,10,0.300000,0.300000,0.300000,13,12,1,true,1,1,34
ReactivePlayer,-3089,10,0.300000,0.300000,0.300000,4,0,4,true,1,4,42
ReactivePlayer,-100128,10,0.300000,0.300000,0.300000,99,96,3,false,0,3,82
ReactivePlayer,-4071,10,0.300000,0.300000,0.300000,5,5,0,true,1,0,22
ReactivePlayer,-77148,10,0.300000,0.300000,0.300000,77,72,5,true,1,5,98
ReactivePlayer,-55567,10,0.300000,0.300000,0.300000,56,49,7,true,1,7,55
ReactivePlayer,-98928,10,0.300000,0.300000,0.300000,99,90,9,true,1,9,86
ReactivePlayer,-5041,10,0.300000,0.300000,0.300000,6,6,0,true,1,0,13
ReactivePlayer,-13317,10,0.300000,0.300000,0.300000,14,11,3,true,1,3,52
ReactivePlayer,-6092,10,0.300000,0.300000,0.300000,7,4,3,true,1,3,39
ReactivePlayer,-33425,10,0.300000,0.300000,0.300000,34,26,8,true,1,8,73
ReactivePlayer,-100525,10,0.300000,0.300000,0.300000,99,91,8,false,0,8,82
ReactivePlayer,-52709,10,0.300000,0.300000,0.300000,53,46,7,true,1,7,77
ReactivePlayer,-23,10,0.300000,0.300000,0.300000,1,1,0,true,1,0,18
ReactivePlayer,-1039,10,0.300000,0.300000,0.300000,2,1,1,true,1,1,14
ReactivePlayer,-154,10,0.300000,0.300000,0.300000,1,0,1,true,1,1,24
ReactivePlayer,-66686,10,0.300000,0.300000,0.300000,66,56,10,true,1,10,96
ReactivePlayer,-9128,10,0.300000,0.300000,0.300000,10,6,4,true,1,4,34
ReactivePlayer,-71988,10,0.300000,0.300000,0.300000,72,63,9,true,1,9,97
ReactivePlayer,-3057,10,0.300000,0.300000,0.300000,4,2,2,true,1,2,26
ReactivePlayer,-3,10,0.300000,0.300000,0.300000,1,0,1,true,1,1,3
ReactivePlayer,-100296,10,0.300000,0.300000,0.300000,100,100,0,false,0,0,2
ReactivePlayer,-22460,10,0.300000,0.300000,0.300000,23,20,3,true,1,3,84
ReactivePlayer,-6073,10,0.300000,0.300000,0.300000,7,5,2,true,1,2,29
ReactivePlayer,-6112,10,0.300000,0.300000,0.300000,7,6,1,true,1,1,26
ReactivePlayer,-52842,10,0.300000,0.300000,0.300000,53,47,6,true,1,6,93
ReactivePlayer,-71889,10,0.300000,0.300000,0.300000,72,67,5,true,1,5,80
ReactivePlayer,-68611,10,0.300000,0.300000,0.300000,69,59,10,true,1,10,88
ReactivePlayer,-21203,10,0.300000,0.300000,0.300000,22,18,4,true,1,4,41
ReactivePlayer,-29903,10,0.300000,0.300000,0.300000,30,26,4,true,1,4,97
ReactivePlayer,-77918,10,0.300000,0.300000,0.300000,76,71,5,true,1,5,94
ReactivePlayer,-70897,10,0.300000,0.300000,0.300000,71,60,11,true,1,11,90
ReactivePlayer,997,10,0.300000,0.300000,0.300000,0,0,0,true,1,0,3
ReactivePlayer,-84739,10,0.300000,0.300000,0.300000,85,73,12,true,1,12,84
ReactivePlayer,-10200,10,0.300000,0.300000,0.300000,11,9,2,true,1,2,41
ReactivePlayer,-14156,10,0.300000,0.300000,0.300000,15,14,1,true,1,1,49
ReactivePlayer,-8125,10,0.300000,0.300000,0.300000,9,5,4,true,1,4,46
ReactivePlayer,-76186,10,0.300000,0.300000,0.300000,76,68,8,true,1,8,93
ReactivePlayer,-20275,10,0.300000,0.300000,0.300000,21,16,5,true,1,5,74
ReactivePlayer,-44641,10,0.300000,0.300000,0.300000,45,37,8,true,1,8,83
ReactivePlayer,-23440,10,0.300000,0.300000,0.300000,24,16,8,true,1,8,61
ReactivePlayer,-7180,10,0.300000,0.300000,0.300000,8,4,4,true,1,4,50
ReactivePlayer,-75803,10,0.300000,0.300000,0.300000,76,68,8,true,1,8,91
ReactivePlayer,-100674,10,0.300000,0.300000,0.300000,99,96,3,false,0,3,99
ReactivePlayer,-25277,10,0.300000,0.300000,0.300000,26,21,5,true,1,5,57
ReactivePlayer,-76804,10,0.300000,0.300000,0.300000,77,72,5,true,1,5,92
ReactivePlayer,-35406,10,0.300000,0.300000,0.300000,36,30,6,true,1,6,84
ReactivePlayer,-100796,10,0.300000,0.300000,0.300000,100,94,6,false,0,6,75
ReactivePlayer,-100463,10,0.300000,0.300000,0.300000,99,92,7,false,0,7,87
ReactivePlayer,-57909,10,0.300000,0.300000,0.300000,58,52,6,true,1,6,90
ReactivePlayer,-34378,10,0.300000,0.300000,0.300000,35,28,7,true,1,7,64
ReactivePlayer,-16236,10,0.300000,0.300000,0.300000,17,9,8,true,1,8,65
ReactivePlayer,-5123,10,0.300000,0.300000,0.300000,6,4,2,true,1,2,29
ReactivePlayer,-11176,10,0.300000,0.300000,0.300000,12,6,6,true,1,6,63
ReactivePlayer,-49689,10,0.300000,0.300000,0.300000,50,40,10,true,1,10,86
ReactivePlayer,-20311,10,0.300000,0.300000,0.300000,21,19,2,true,1,2,36
ReactivePlayer,-20403,10,0.300000,0.300000,0.300000,21,16,5,true,1,5,83
ReactivePlayer,-20416,10,0.300000,0.300000,0.300000,21,19,2,true,1,2,69
ReactivePlayer,-34375,10,0.300000,0.300000,0.300000,35,32,3,true,1,3,49
ReactivePlayer,-1216,10,0.300000,0.300000,0.300000,2,2,0,true,1,0,37
ReactivePlayer,-55591,10,0.300000,0.300000,0.300000,56,50,6,true,1,6,83
ReactivePlayer,-50769,10,0.300000,0.300000,0.300000,51,47,4,true,1,4,84
ReactivePlayer,-2018,10,0.300000,0.300000,0.300000,3,3,0,true,1,0,8
ReactivePlayer,-7061,10,0.300000,0.300000,0.300000,8,7,1,true,1,1,28
ReactivePlayer,-100488,10,0.300000,0.300000,0.300000,99,94,5,false,0,5,79
ReactivePlayer,-26792,10,0.300000,0.300000,0.300000,27,21,6,true,1,6,96
ReactivePlayer,-18269,10,0.300000,0.300000,0.300000,19,15,4,true,1,4,58
ReactivePlayer,-4078,10,0.300000,0.300000,0.300000,5,4,1,true,1,1,28
ReactivePlayer,-34478,10,0.300000,0.300000,0.300000,35,32,3,true,1,3,53
ReactivePlayer,-2064,10,0.300000,0.300000,0.300000,3,0,3,true,1,3,27
ReactivePlayer,-1031,10,0.300000,0.300000,0.300000,2,2,0,true,1,0,9
ReactivePlayer,-100251,10,0.300000,0.300000,0.300000,99,93,6,false,0,6,90
ReactivePlayer,997,10,0.300000,0.300000,0.300000,0,0,0,true,1,0,2
ReactivePlayer,-53621,10,0.300000,0.300000,0.300000,54,51,3,true,1,3,87
ReactivePlayer,-14220,10,0.300000,0.300000,0.300000,15,13,2,true,1,2,54
ReactivePlayer,-6104,10,0.300000,0.300000,0.300000,7,5,2,true,1,2,26
ReactivePlayer,-47916,10,0.300000,0.300000,0.300000,48,42,6,true,1,6,86
ReactivePlayer,-9436,10,0.300000,0.300000,0.300000,10,7,3,true,1,3,66
ReactivePlayer,-2059,10,0.300000,0.300000,0.300000,3,2,1,true,1,1,17
ReactivePlayer,-34775,10,0.300000,0.300000,0.300000,35,30,5,true,1,5,94
ReactivePlayer,996,10,0.300000,0.300000,0.300000,0,0,0,true,1,0,4
ReactivePlayer,-17176,10,0.300000,0.300000,0.300000,18,11,7,true,1,7,54
ReactivePlayer,966,10,0.300000,0.300000,0.300000,0,0,0,true,1,0,10
ReactivePlayer,-100080,10,0.300000,0.300000,0.300000,99,94,5,false,0,5,81
ReactivePlayer,-13196,10,0.300000,0.300000,0.300000,14,9,5,true,1,5,47
ReactivePlayer,-25478,10,0.300000,0.300000,0.300000,26,20,6,true,1,6,54
ReactivePlayer,-3029,10,0.300000,0.300000,0.300000,4,1,3,true,1,3,14
ReactivePlayer,-43515,10,0.300000,0.300000,0.300000,44,37,7,true,1,7,84
ReactivePlayer,970,10,0.300000,0.300000,0.300000,0,0,0,true,1,0,3
ReactivePlayer,-31190,10,0.300000,0.300000,0.300000,32,31,1,true,1,1,25
ReactivePlayer,-6048,10,0.300000,0.300000,0.300000,7,4,3,true,1,3,26
ReactivePlayer,988,10,0.300000,0.300000,0.300000,0,0,0,true,1,0,11
ReactivePlayer,-22511,10,0.300000,0.300000,0.300000,23,18,5,true,1,5,65
ReactivePlayer,-25572,10,0.300000,0.300000,0.300000,26,25,1,true,1,1,80
ReactivePlayer,-100338,10,0.300000,0.300000,0.300000,99,90,9,false,0,9,98
ReactivePlayer,-32248,10,0.300000,0.300000,0.300000,33,29,4,true,1,4,66
ReactivePlayer,-7179,10,0.300000,0.300000,0.300000,8,7,1,true,1,1,40
ReactivePlayer,-67140,10,0.300000,0.300000,0.300000,67,63,4,true,1,4,96
ReactivePlayer,-26669,10,0.300000,0.300000,0.300000,27,17,10,true,1,10,74
ReactivePlayer,-7421,10,0.300000,0.300000,0.300000,8,4,4,true,1,4,65
ReactivePlayer,-78105,10,0.300000,0.300000,0.300000,78,71,7,true,1,7,69
ReactivePlayer,995,10,0.300000,0.300000,0.300000,0,0,0,true,1,0,3
ReactivePlayer,-2082,10,0.300000,0.300000,0.300000,3,3,0,true,1,0,31
ReactivePlayer,-3063,10,0.300000,0.300000,0.300000,4,0,4,true,1,4,23
ReactivePlayer,-1056,10,0.300000,0.300000,0.300000,2,0,2,true,1,2,17
ReactivePlayer,-7186,10,0.300000,0.300000,0.300000,8,1,7,true,1,7,50
ReactivePlayer,-8116,10,0.300000,0.300000,0.300000,9,6,3,true,1,3,29
ReactivePlayer,-49078,10,0.300000,0.300000,0.300000,49,40,9,true,1,9,83
